border_size=1
usage=map

Qxu^Xo      , Qxu^Xo      , Qxu^Xo      , Qxu^Xo      , Qxu^Xo      , Qxu^Xo      , Qxu^Xo      , Qxu^Xo      , Qxu^Xo      , Qxu^Xo      , Qxu^Xo      , Qxu^Xo      , Qxu^Xo      , Qxu^Xo      , Qxu^Xo      , Qxu^Xo      , Qxu^Xo      , Qxu^Xo      , Qxu^Xo      , Qxu^Xo      , Qxu^Xo      , Qxu^Xo      , Qxu^Xo      , Qxu^Xo      , Qxu^Xo      , Qxu^Xo      , Qxu^Xo      , Qxu^Xo      , Qxu^Xo      , Qxu^Xo      , Qxu^Xo      , Qxu^Xo      , Qxu^Xo      , Qxu^Xo      , Qxu^Xo      , Qxu^Xo      , Qxu^Xo      , Qxu^Xo      , Qxu^Xo      , Qxu^Xo      , Qxu^Xo      , Qxu^Xo      , Qxu^Xo      , Qxu^Xo      
Qxu^Xo      , Qxu^Xo      , Qxu^Xo      , Qxu^Xo      , Qxu^Xo      , Qxu^Xo      , Qxu^Xo      , Qxu^Xo      , Qxu^Xo      , Qxu^Xo      , Qxu^Xo      , Qxu^Xo      , Qxu^Xo      , Qxu^Xo      , Qxu^Xo      , Qxu^Xo      , Qxu^Xo      , Qxu^Xo      , Qxu^Xo      , Qxu^Xo      , Qxu^Xo      , Qxu^Xo      , Qxu^Xo      , Qxu^Xo      , Qxu^Xo      , Qxu^Xo      , Qxu^Xo      , Qxu^Xo      , Qxu^Xo      , Qxu^Xo      , Qxu^Xo      , Qxu^Xo      , Qxu^Xo      , Qxu^Xo      , Qxu^Xo      , Qxu^Xo      , Qxu^Xo      , Qxu^Xo      , Qxu^Xo      , Qxu^Xo      , Qxu^Xo      , Qxu^Xo      , Qxu^Xo      , Qxu^Xo      
Qxu^Xo      , Qxu^Xo      , Qxu^Xo      , Qxu^Xo      , Qxu^Xo      , Qxu^Xo      , Qxu^Xo      , Qxu^Xo      , Qxu^Xo      , Qxu^Xo      , Qxu^Xo      , Qxu^Xo      , Qxu^Xo      , Qxu^Xo      , Qxu^Xo      , Qxu^Xo      , Qxu^Xo      , Qxu^Xo      , Qxu^Xo      , Qxu^Xo      , Qxu^Xo      , Qxu^Xo      , Qxu^Xo      , Qxu^Xo      , Qxu^Bs/     , Cud         , Qxu^Bs\     , Qxu^Xo      , Qxu^Xo      , Qxu^Xo      , Qxu^Xo      , Qxu^Xo      , Qxu^Xo      , Qxu^Xo      , Qxu^Xo      , Qxu^Xo      , Cud         , Uu          , Uu^Uf       , Uu          , Ql          , Ql          , Ql          , Uu^Fp       
Qxu^Xo      , Qxu^Xo      , Qxu^Xo      , Qxu^Xo      , Qxu^Xo      , Qxu^Xo      , Qxu^Xo      , Qxu^Xo      , Qxu^Xo      , Qxu^Xo      , Qxu^Xo      , Qxu^Xo      , Qxu^Xo      , Qxu^Xo      , Ql          , Qxu^Xo      , Uu^Uf       , Qxu^Xo      , Ql          , Qxu^Xo      , Uu^Fp       , Qxu^Xo      , Qxu^Xo      , Cud         , Qxu^Xo      , Qxu^Xo      , Qxu^Xo      , Cud         , Qxu^Xo      , Qxu^Xo      , Qxu^Xo      , Qxu^Xo      , Qxu^Xo      , Qxu^Xo      , Qxu^Xo      , Qxu^Xo      , Qxu^Xo      , Qxu^Xo      , Qxu^Xo      , Ql^Bs\      , Uu^Uf       , Uu^Fp       , Uu^Fp       , Uu^Fp       
Qxu^Xo      , Qxu^Xo      , Qxu^Xo      , Qxu^Xo      , Qxu^Xo      , Qxu^Xo      , Qxu^Xo      , Qxu^Xo      , Qxu^Xo      , Qxu^Xo      , Qxu^Xo      , Qxu^Xo      , Qxu^Xo      , Ql          , Uu          , Uu^Fp       , Re          , Uu^Fp       , Uu^Fp       , Uu^Uf       , Re          , Uu^Uf       , Uu^Fp       , Qxu^Xo      , Uu^Uf       , Uu^Fp       , Uu^Fp       , Qxu^Xo      , Uu          , Qxu^Xo      , Qxu^Xo      , Qxu^Xo      , Qxu^Xo      , Qxu^Xo      , Qxu^Xo      , Qxu^Xo      , Qxu^Xo      , Qxu^Xo      , Qxu^Xo      , Qxu^Xo      , Qxu^Xo      , Qxu^Xo      , Ql          , Uu^Uf       
Qxu^Xo      , Qxu^Xo      , Qxu^Xo      , Qxu^Xo      , Qxu^Xo      , Qxu^Xo      , Qxu^Xo      , Qxu^Xo      , Cud         , Qxu^Xo      , Qxu^Xo      , Qxu^Xo      , Uu^Uf       , Uu^Fp       , Re          , Re          , Gs^Fp       , Re          , Re          , Re          , Ur          , Re          , Re          , Uu          , Qxu         , Cud         , Ql          , Uu^Uf       , Uu^Fp       , Uu^Fp       , Uu^Fp       , Qxu^Xo      , Qxu^Xo      , Qxu^Xo      , Qxu^Xo      , Qxu^Xo      , Qxu^Xo      , Qxu^Xo      , Qxu^Xo      , Qxu^Xo      , Qxu^Xo      , Qxu^Xo      , Ql          , Uu^Fp       
Qxu^Xo      , Qxu^Xo      , Qxu^Xo      , Qxu^Xo      , Qxu^Xo      , Qxu^Xo      , Cud         , Qxu^Bs/     , Qxu^Xo      , Qxu^Xo      , Ql          , Ql          , Ur          , Re          , Gs^Fp       , Hh          , Gg^Uf       , Re          , Uu^Fp       , Uu^Uf       , Ur          , Uu^Vud      , Ql          , Re          , Cud         , Cud         , 1 Kud       , Ur          , Ql^Bs\      , Ql          , Qxu         , Uu^Fp       , Uu          , Qxu^Xo      , Qxu^Xo      , Qxu^Xo      , Qxu^Xo      , Qxu^Xo      , Qxu^Xo      , Qxu^Xo      , Qxu^Xo      , Qxu^Xo      , Qxu^Xo      , Ql          
Qxu^Xo      , Qxu^Xo      , Qxu^Xo      , Qxu^Xo      , Qxu^Xo      , Qxu^Xo      , Qxu^Bs|     , Qxu^Xo      , Uu^Uf       , Ur          , Kud         , Cud         , Uu^Fp       , Re          , Gg          , Ggf         , Rr^Vd       , Re          , Re          , Ur          , Ql^Bs\      , Ur          , Ur          , Ur          , Rp          , Cud         , Rp          , Qxu         , Cud         , Cud         , Qxu         , Uu^Uf       , Uu^Fp       , Ql          , Qxu^Xo      , Cud         , Qxu^Bs\     , Qxu^Xo      , Qxu^Xo      , Qxu^Xo      , Qxu^Xo      , Qxu^Xo      , Qxu^Xo      , Uu          
Qxu^Xo      , Qxu^Xo      , Qxu^Xo      , Qxu^Xo      , Qxu^Xo      , Qxu^Xo      , Cud         , Qxu^Xo      , Uu^Uf       , Cud         , Qxu^Bs\     , Ql          , Qxu^Bs/     , Re          , Gg          , Rp          , Ggf         , Rp          , Rp          , Ur          , Qxu         , Ur          , Rp          , Rp          , Gg          , Rp          , Gg          , Rp          , Gg          , Cud         , Re          , Ur          , Ur          , Uu          , Uu^Uf       , Qxu^Xo      , Qxu^Xo      , Cud         , Qxu^Xo      , Qxu^Xo      , Qxu^Xo      , Qxu^Xo      , Qxu^Xo      , Qxu^Xo      
Qxu^Xo      , Qxu^Xo      , Qxu^Xo      , Qxu^Xo      , Qxu^Xo      , Qxu^Xo      , Qxu^Xo      , Qxu^Xo      , Ql          , Ql^Bs|      , Ql          , Cud         , Ql          , Re          , Gg          , Rp          , Gg          , Gg          , Rp          , Cud         , Cud         , Rp          , Gs^Fp       , Ggf         , Hh          , Gg          , Ggf         , Rp          , Ggf         , Gg          , Gg          , Re          , Uu^Vud      , Qxu         , Ql          , Uu^Fp       , Uu^Fp       , Qxu^Xo      , Uh          , Uu^Uf       , Uu^Uf       , Qxu^Xo      , Qxu^Xo      , Qxu^Xo      
Qxu^Xo      , Qxu^Xo      , Qxu^Xo      , Qxu^Xo      , Qxu^Xo      , Qxu^Xo      , Qxu^Xo      , Qxu^Xo      , Cud         , Cud         , Uu^Fp       , Qxu^Bs|     , Re          , Re          , Gg          , Rp          , Gg          , Gg          , Rp          , Kud         , Ur          , Rp          , Rp          , Gg          , Gg          , Gg          , Rp          , Rp          , Rp          , Cud         , Cud         , Re          , Re          , Ur          , Ur          , Qxu         , Ur          , Uu          , Re          , Ql          , Uh          , Qxu^Xo      , Qxu^Xo      , Qxu^Xo      
Qxu^Xo      , Qxu^Xo      , Qxu^Xo      , Qxu^Xo      , Qxu^Xo      , Qxu^Xo      , Qxu^Xo      , Cud         , Cud         , Re          , Re          , Re          , Hh          , Gs^Fp       , Gg          , Rp          , Gg          , Gg          , Gs^Fp       , Rp          , Rp          , Cud         , Kud         , Rp          , Rp          , Rr^Vd       , Gg          , Gg          , Gg          , Rp          , Kud         , Gg          , Gg          , Re          , Re          , Ur          , Re          , Re          , Rr^Vd       , Re          , Uu^Fp       , Qxu^Xo      , Qxu^Xo      , Qxu^Xo      
Qxu^Xo      , Qxu^Xo      , Qxu^Xo      , Qxu^Xo      , Qxu^Xo      , Qxu^Xo      , Qxu^Xo      , Ql          , Kud         , Ur          , Re          , Mm          , Hh^Uf       , Gg          , Rp          , Rp          , Gg          , Gg^Uf       , Hh          , Mm          , Rp          , Re          , Re          , Re          , Re          , Gg          , Gg          , Ggf         , Gg          , Rp          , Rp          , Ggf         , Rp          , Rp          , Rp          , Kud         , Gg          , Gg          , Rp          , Re          , Re          , Qxu^Xo      , Qxu^Xo      , Qxu^Xo      
Qxu^Xo      , Qxu^Xo      , Qxu^Xo      , Qxu^Xo      , Cud         , Qxu^Xo      , Qxu^Xo      , Uu^Uf       , Uu^Fp       , Ur          , Re          , Gs^Fp       , Gg          , Gg          , Rr^Vd       , Ggf         , Gg          , Gs^Fp       , Hh          , Rp          , Uu^Uf       , Ur          , Cud         , Ql^Bs|      , Ql          , Re          , Re          , Gg          , Rp          , Mm          , Hh          , Rp          , Kud         , Ur          , Ql          , Cud         , Rp          , Rp          , Gg          , Ggf         , Re          , Qxu^Xo      , Qxu^Xo      , Qxu^Xo      
Qxu^Xo      , Qxu^Xo      , Qxu^Xo      , Qxu^Xo      , Qxu^Bs|     , Qxu^Bs\     , Cud         , Qxu^Xo      , Re          , Re          , Ggf         , Gg          , Rp          , Rp          , Gg          , Rp          , Gg          , Hh^Uf       , Mm          , Rp          , Ql          , Ur          , Ur          , Kud         , Gs^Fp       , Qxu         , Qxu         , Re          , Rp          , Gs^Fp       , Cud         , Ql^Bs/      , Cud         , Ur          , Ur          , Re          , Rp          , Gg          , Hh          , Gs^Fp       , Re          , Ql          , Qxu^Xo      , Qxu^Xo      
Qxu^Xo      , Qxu^Xo      , Qxu^Xo      , Qxu^Xo      , Cud         , Qxu^Bs/     , Qxu^Xo      , Qxu^Xo      , Re          , Mm          , Rp          , Rp          , Gg          , Gg          , Gg          , Rp          , Gg          , Hh          , Gs^Fp       , Rp          , Uu          , Uu          , Uu          , Ur          , Uh          , Hh          , Rp          , Rp          , Ur          , Re          , Re          , Qxu         , Qxu         , Cud         , Ur          , Re          , Rp          , Gg          , Gg          , Gs^Fp       , Re          , Ql          , Qxu^Xo      , Qxu^Xo      
Qxu^Xo      , Qxu^Xo      , Qxu^Xo      , Qxu^Xo      , Qxu^Xo      , Qxu^Xo      , Re          , Re          , Rp          , Rp          , Gs^Fp       , Gg          , Ggf         , Gg          , Rp          , Rp          , Rp          , Ggf         , Rp          , Rp          , Xu          , Xu          , Gs^Fp       , Cud         , Cud         , Rp          , Hh          , Qxu         , Ql          , Ur          , Re          , Ur          , Ur          , Ur          , Rp          , Rp          , Hh          , Rp          , Cud         , Gg          , Re          , Qxu^Xo      , Qxu^Xo      , Qxu^Xo      
Qxu^Xo      , Qxu^Xo      , Qxu^Xo      , Qxu^Xo      , Qxu^Xo      , Ql          , Re          , Cud         , Rp          , Hh          , Gg          , Gg          , Rp          , Rp          , Uu          , Uu          , Ur          , Rp          , Cud         , Uh          , Uu^Uf       , Gs^Fp       , Uu          , Xu          , Uu^Uf       , Xu          , Xu          , Hh^Uf       , Ql          , Ur          , Gs^Fp       , Re          , Rp          , Rp          , Gg          , Gs^Fp       , Rp          , Rp          , Re          , Re          , Qxu^Xo      , Qxu^Xo      , Qxu^Xo      , Qxu^Xo      
Qxu^Xo      , Qxu^Xo      , Qxu^Xo      , Qxu^Xo      , Ql          , Re          , Cud         , Rp          , Hh          , Gs^Fp       , Gg          , Gg          , Rp          , Uu^Uf       , Uu^Uf       , Qxu         , Hh          , Xu          , Uh          , Kud         , Gs^Fp       , Ql          , Ql          , Gs^Fp       , Kud         , Uh          , Xu          , Hh          , Qxu         , Uu^Uf       , Uu^Uf       , Rp          , Gg          , Gg          , Gs^Fp       , Hh          , Rp          , Cud         , Re          , Ql          , Qxu^Xo      , Qxu^Xo      , Qxu^Xo      , Qxu^Xo      
Qxu^Xo      , Qxu^Xo      , Qxu^Xo      , Qxu^Xo      , Re          , Re          , Rp          , Rp          , Gs^Fp       , Gg          , Rp          , Rp          , Re          , Gs^Fp       , Ur          , Ql          , Hh^Uf       , Xu          , Xu          , Uu^Uf       , Xu          , Uu          , Gs^Fp       , Uu^Uf       , Uh          , Cud         , Rp          , Ur          , Uu          , Uu          , Rp          , Rp          , Gg          , Gg          , Hh          , Rp          , Cud         , Re          , Ql          , Qxu^Xo      , Qxu^Xo      , Qxu^Xo      , Qxu^Xo      , Qxu^Xo      
Qxu^Xo      , Qxu^Xo      , Qxu^Xo      , Re          , Ggf         , Cud         , Rp          , Hh          , Rp          , Rp          , Ur          , Ur          , Ur          , Re          , Ur          , Ql          , Qxu         , Hh          , Rp          , Cud         , Cud         , Gs^Fp       , Xu          , Xu          , Rp          , Rp          , Ggf         , Rp          , Rp          , Rp          , Gg          , Ggf         , Gg          , Gs^Fp       , Rp          , Rp          , Re          , Re          , Qxu^Xo      , Qxu^Xo      , Qxu^Xo      , Qxu^Xo      , Qxu^Xo      , Qxu^Xo      
Qxu^Xo      , Qxu^Xo      , Ql          , Re          , Hh          , Gg          , Gg          , Rp          , Re          , Ur          , Cud         , Qxu         , Qxu         , Re          , Rp          , Ur          , Rp          , Rp          , Hh          , Uh          , Ur          , Uu          , Uu          , Uu          , Rp          , Gs^Fp       , Hh          , Gg          , Rp          , Gg          , Gg          , Gg          , Rp          , Rp          , Mm          , Re          , Qxu^Xo      , Qxu^Xo      , Qxu^Bs/     , Cud         , Qxu^Xo      , Qxu^Xo      , Qxu^Xo      , Qxu^Xo      
Qxu^Xo      , Qxu^Xo      , Ql          , Re          , Gs^Fp       , Gs^Fp       , Rp          , Rp          , Re          , Ur          , Qxu         , Cud         , Ql^Bs/      , Cud         , Re          , Rp          , Re          , Qxu         , Qxu         , Gs^Fp       , Cud         , Ur          , Ur          , Ql          , Rp          , Mm          , Hh^Uf       , Gg          , Rp          , Gg          , Rp          , Rp          , Gg          , Ggf         , Re          , Re          , Qxu^Xo      , Cud         , Qxu^Bs\     , Qxu^Bs|     , Qxu^Xo      , Qxu^Xo      , Qxu^Xo      , Qxu^Xo      
Qxu^Xo      , Qxu^Xo      , Qxu^Xo      , Re          , Ggf         , Gg          , Rp          , Re          , Cud         , Ql          , Ur          , Kud         , Rp          , Hh          , Mm          , Re          , Gg          , Re          , Re          , Ql          , Ql^Bs/      , Kud         , Ur          , Uu^Uf       , Rp          , Hh          , Gs^Fp       , Gg          , Ggf         , Rp          , Gg          , Gg          , Gs^Fp       , Re          , Uu          , Uu^Fp       , Ql          , Qxu^Xo      , Qxu^Xo      , Cud         , Qxu^Xo      , Qxu^Xo      , Qxu^Xo      , Qxu^Xo      
Qxu^Xo      , Qxu^Xo      , Qxu^Xo      , Re          , Re          , Gg          , Rp          , Re          , Kud         , Rp          , Rp          , Rp          , Gg          , Rp          , Gg          , Ggf         , Rp          , Rp          , Rr^Vd       , Re          , Re          , Ur          , Gs^Fp       , Rp          , Mm          , Hh          , Gg^Uf       , Gg          , Rr^Vd       , Rp          , Ggf         , Hh^Uf       , Mm          , Re          , Ur          , Kud         , Uu^Uf       , Qxu^Xo      , Qxu^Xo      , Qxu^Xo      , Qxu^Xo      , Qxu^Xo      , Qxu^Xo      , Qxu^Xo      
Qxu^Xo      , Qxu^Xo      , Qxu^Xo      , Uu^Fp       , Re          , Rr^Vd       , Re          , Re          , Ur          , Re          , Re          , Gg          , Ggf         , Rp          , Rp          , Gg          , Rp          , Ggf         , Gg          , Rp          , Rp          , Re          , Cud         , Rp          , Rp          , Gs^Fp       , Gg          , Rp          , Gg          , Gg          , Gs^Fp       , Hh          , Re          , Re          , Re          , Cud         , Uh          , Qxu^Xo      , Qxu^Xo      , Qxu^Xo      , Qxu^Xo      , Qxu^Xo      , Qxu^Xo      , Qxu^Xo      
Qxu^Xo      , Qxu^Xo      , Qxu^Xo      , Uh          , Ql          , Re          , Uu          , Ur          , Qxu         , Ur          , Ur          , Re          , Re          , Kud         , Cud         , Rp          , Kud         , Rp          , Gg          , Gg          , Gg          , Kud         , Rp          , Ur          , Cud         , Rp          , Gg          , Rp          , Gg          , Ggf         , Re          , Re          , Qxu^Bs|     , Uu^Fp       , Kud         , Cud         , Ql          , Qxu^Xo      , Qxu^Xo      , Qxu^Xo      , Qxu^Xo      , Qxu^Xo      , Qxu^Xo      , Qxu^Xo      
Qxu^Xo      , Qxu^Xo      , Qxu^Xo      , Uu^Uf       , Uu^Uf       , Uh          , Qxu^Xo      , Uu^Fp       , Uu^Fp       , Ql          , Qxu         , Uu^Vud      , Re          , Ql          , Re          , Cud         , Rp          , Rp          , Gg          , Hh          , Gg          , Gs^Fp       , Rp          , Cud         , Kud         , Rp          , Gg          , Rp          , Rp          , Gg          , Re          , Ql          , Cud         , Ql          , Uu^Fp       , Ur          , Qxu^Xo      , Qxu^Xo      , Qxu^Xo      , Qxu^Xo      , Qxu^Xo      , Qxu^Xo      , Qxu^Xo      , Qxu^Xo      
Qxu^Xo      , Qxu^Xo      , Qxu^Xo      , Qxu^Xo      , Qxu^Xo      , Qxu^Xo      , Cud         , Qxu^Xo      , Qxu^Xo      , Uu^Uf       , Uu          , Ur          , Ur          , Re          , Cud         , Re          , Rp          , Gg          , Ggf         , Gg          , Rp          , Rp          , Ur          , Qxu         , Ur          , Rp          , Gg          , Ggf         , Rp          , Gg          , Re          , Qxu^Bs/     , Ql          , Qxu^Bs\     , Uu^Fp       , Ur          , Qxu^Xo      , Cud         , Qxu^Xo      , Qxu^Xo      , Qxu^Xo      , Qxu^Xo      , Qxu^Xo      , Qxu^Xo      
Uu          , Qxu^Xo      , Qxu^Xo      , Qxu^Xo      , Qxu^Xo      , Qxu^Xo      , Qxu^Xo      , Qxu^Bs\     , Cud         , Qxu^Xo      , Ql          , Uu^Fp       , Uu^Uf       , Qxu         , Cud         , Cud         , Qxu         , 2 Kud       , Cud         , Cud         , Ur          , Ur          , Ur          , Ql^Bs\      , Ur          , Rp          , Hh          , Gg^Uf       , Rp          , Gg          , Re          , Uu^Fp       , Uh          , Ur          , Uu          , Ql          , Qxu^Xo      , Qxu^Bs|     , Qxu^Xo      , Qxu^Xo      , Qxu^Xo      , Qxu^Xo      , Qxu^Xo      , Qxu^Xo      
Ql          , Qxu^Xo      , Qxu^Xo      , Qxu^Xo      , Qxu^Xo      , Qxu^Xo      , Qxu^Xo      , Qxu^Xo      , Qxu^Xo      , Qxu^Xo      , Qxu^Xo      , Uu          , Uu^Fp       , Qxu         , Ql          , Ql^Bs\      , Ur          , Ur          , Cud         , Re          , Re          , Ql          , Uu^Vud      , Ur          , Uu^Uf       , Rp          , Rp          , Gs^Fp       , Rp          , Gg          , Re          , Uu^Uf       , Ql          , Ql^Bs|      , Qxu^Xo      , Qxu^Xo      , Qxu^Bs/     , Cud         , Qxu^Xo      , Qxu^Xo      , Qxu^Xo      , Qxu^Xo      , Qxu^Xo      , Qxu^Xo      
Uu^Fp       , Ql          , Qxu^Xo      , Qxu^Xo      , Qxu^Xo      , Qxu^Xo      , Qxu^Xo      , Qxu^Xo      , Qxu^Xo      , Qxu^Xo      , Qxu^Xo      , Qxu^Xo      , Qxu^Xo      , Uu^Fp       , Uu^Fp       , Ur^Fp       , Uu^Uf       , Ql          , Qxu         , Qxu         , Uu          , Re          , Re          , Ur          , Re          , Re          , Re          , Rr^Vd       , Re          , Re          , Uu^Fp       , Ur          , Cud         , Kud         , Qxu^Xo      , Cud         , Qxu^Xo      , Qxu^Xo      , Qxu^Xo      , Qxu^Xo      , Qxu^Xo      , Qxu^Xo      , Qxu^Xo      , Qxu^Xo      
Uu^Uf       , Ql          , Qxu^Xo      , Qxu^Xo      , Qxu^Xo      , Qxu^Xo      , Qxu^Xo      , Qxu^Xo      , Qxu^Xo      , Qxu^Xo      , Qxu^Xo      , Qxu^Xo      , Qxu^Xo      , Qxu^Xo      , Qxu^Xo      , Uu          , Qxu^Xo      , Uu^Fp       , Uu^Fp       , Uu^Uf       , Qxu^Xo      , Uu^Fp       , Uu^Uf       , Re          , Uu^Uf       , Uu^Fp       , Uu^Fp       , Re          , Uu^Fp       , Uu          , Ql          , Qxu^Xo      , Qxu^Xo      , Qxu^Xo      , Qxu^Xo      , Qxu^Xo      , Qxu^Xo      , Qxu^Xo      , Qxu^Xo      , Qxu^Xo      , Qxu^Xo      , Qxu^Xo      , Qxu^Xo      , Qxu^Xo      
Uu^Fp       , Uu^Fp       , Uu^Fp       , Uu^Uf       , Ql^Bs\      , Qxu^Xo      , Qxu^Xo      , Qxu^Xo      , Qxu^Xo      , Qxu^Xo      , Qxu^Xo      , Qxu^Xo      , Qxu^Xo      , Qxu^Xo      , Qxu^Xo      , Qxu^Xo      , Cud         , Qxu^Xo      , Qxu^Xo      , Qxu^Xo      , Cud         , Qxu^Xo      , Qxu^Xo      , Uu^Fp       , Qxu^Xo      , Ql          , Qxu^Xo      , Uu^Uf       , Qxu^Xo      , Ql          , Qxu^Xo      , Qxu^Xo      , Qxu^Xo      , Qxu^Xo      , Qxu^Xo      , Qxu^Xo      , Qxu^Xo      , Qxu^Xo      , Qxu^Xo      , Qxu^Xo      , Qxu^Xo      , Qxu^Xo      , Qxu^Xo      , Qxu^Xo      
Uu^Fp       , Ql          , Ql          , Ql          , Uu          , Uu^Uf       , Uu          , Cud         , Qxu^Xo      , Qxu^Xo      , Qxu^Xo      , Qxu^Xo      , Qxu^Xo      , Qxu^Xo      , Qxu^Xo      , Qxu^Xo      , Qxu^Xo      , Qxu^Bs\     , Cud         , Qxu^Bs/     , Qxu^Xo      , Qxu^Xo      , Qxu^Xo      , Qxu^Xo      , Qxu^Xo      , Qxu^Xo      , Qxu^Xo      , Qxu^Xo      , Qxu^Xo      , Qxu^Xo      , Qxu^Xo      , Qxu^Xo      , Qxu^Xo      , Qxu^Xo      , Qxu^Xo      , Qxu^Xo      , Qxu^Xo      , Qxu^Xo      , Qxu^Xo      , Qxu^Xo      , Qxu^Xo      , Qxu^Xo      , Qxu^Xo      , Qxu^Xo      
Qxu^Xo      , Qxu^Xo      , Qxu^Xo      , Qxu^Xo      , Qxu^Xo      , Qxu^Xo      , Qxu^Xo      , Qxu^Xo      , Qxu^Xo      , Qxu^Xo      , Qxu^Xo      , Qxu^Xo      , Qxu^Xo      , Qxu^Xo      , Qxu^Xo      , Qxu^Xo      , Qxu^Xo      , Qxu^Xo      , Qxu^Xo      , Qxu^Xo      , Qxu^Xo      , Qxu^Xo      , Qxu^Xo      , Qxu^Xo      , Qxu^Xo      , Qxu^Xo      , Qxu^Xo      , Qxu^Xo      , Qxu^Xo      , Qxu^Xo      , Qxu^Xo      , Qxu^Xo      , Qxu^Xo      , Qxu^Xo      , Qxu^Xo      , Qxu^Xo      , Qxu^Xo      , Qxu^Xo      , Qxu^Xo      , Qxu^Xo      , Qxu^Xo      , Qxu^Xo      , Qxu^Xo      , Qxu^Xo      
