border_size=1
usage=map

Xu          , Xu          , Xu          , Xu          , Xu          , Xu          , Xu          , Xu          , Xu          , Xu          , Xu          , Xu          , Xu          , Xu          , Xu          , Xu          , Xu          , Xu          , Xu          , Xu          , Xu          , Xu          , Xu          , Xu          , Xu          , Xu          , Xu          , Xu          , Xu          , Xu          , Xu          , Xu          , Xu          , Xu          , Xu          , Xu          , Xu          , Xu          , Xu          
Xu          , Xu          , Xu          , Xu          , Uh          , Xu          , Xu          , Xu          , Xu          , Xu          , Xu          , Xu          , Xu          , Xu          , Xu          , Xu          , Xu          , Xu          , Xu          , Xu          , Xu          , Xu          , Xu          , Xu          , Xu          , Xu          , Xu          , Xu          , Xu          , Xu          , Xu          , Xu          , Xu          , Xu          , Xu          , Xu          , Xu          , Xu          , Xu          
Xu          , Xu          , Xu          , Xu          , Ur          , Xu          , Ur          , Rd          , Uu          , Uu          , Uu          , Uh          , Uu^Uf       , Uu          , Ur          , Uu          , Cud         , Gs^Fdw      , Ur          , Rd          , Uu          , Uu          , Xu          , Xu          , Uu          , Uu          , Uu          , Gs^Fdw      , Uu          , Xu          , Cud         , Rd          , Ur          , Uh          , Gs^Fdw      , Uu          , Uu          , Xu          , Xu          
Xu          , Xu          , Xu          , Xu          , Uu^Vud      , Wwf         , Ur          , Rd          , Ds          , Cud         , Gs^Fdw      , Ur          , Ur          , Gs^Fdw      , Uu^Vud      , Uu          , Ur          , Uu          , Ds          , Rd          , Ds          , Uu^Uf       , Ur          , Cud         , Uu^Vud      , Gs^Fdw      , Uu^Uf       , Uu^Uf       , Ur          , Uu          , Ds          , Rd          , Uu^Uf       , Ur          , Uu^Vud      , Uu          , Xu          , Xu          , Xu          
Xu          , Uh          , Uh          , Uu          , Ur          , Gs^Fdf      , Gs^Fdw      , Rd          , Ds          , Uh          , Ur          , Ur          , Gs^Fdf      , Ur          , Xu          , Ur          , Uh          , Ur          , Md          , Rd          , Gs^Fdf      , Ur          , Uh          , Ur          , Ds          , Ur          , Gs^Fdf      , Ur          , Ur          , Md          , Gs^Fdw      , Uu          , Rd          , Uh          , Uh          , Ur          , Uu          , Xu          , Xu          
Uu          , Uu          , Uu          , Uu          , Ur          , Uu^Uf       , Rd          , Rd          , Gs^Fdf      , Re          , Wwf         , Wwf         , Ur          , Md          , Xu          , Xu          , Uu          , Ur          , Uu^Uf       , Wwf         , Uu^Uf       , Ur          , Uu          , Wwf         , Xu          , Xu          , Wwf         , Ds          , Ds          , Uu          , Uh          , Gs^Fdw      , Ur          , Rd          , Rd          , Ur          , Uu          , Uh          , Xu          
Ur          , Uu          , Ur          , Ur          , Rd          , Rd          , Md          , Uu^Vud      , Uu          , Ww          , Wwf         , Re          , Wwf         , Ds          , Ur          , Gs^Fdw      , Uh          , Ur          , Ur          , Ur          , Ur          , Ur          , Cud         , Uh          , Ur          , Uu^Uf       , Ur          , Wwf         , Wwf         , Ur          , Uh          , Uu^Vud      , Ur          , Ds          , Rd          , Ur          , Ur          , Uu          , Ur          
Ww          , Ur          , Ds          , Ur          , Chw         , Ds          , Ur          , Uh          , Ur          , Re          , Ur          , Ww^Vm       , Re          , Ur          , Gs^Fdf      , Ur          , Cud         , Ur          , Gs^Fdf      , Ur          , Md          , Ds          , Gs^Fdf      , Ur          , Ss^Vhs      , Ur          , Gs^Fdf      , Gs^Fdf      , Wwf         , Re          , Re          , Gs^Fdf      , Ur          , Ur          , Ch          , Ur          , Ur          , Ur          , Ur          
Ww          , Ww          , Wwf         , Khw         , Wwf         , Ch          , Re          , Ur          , Ur          , Uh          , Ds          , Wwf         , Re          , Gs^Fdf      , Ss^Vhs      , Ur          , Re          , Re          , Ww          , Wwr         , Ww          , Re          , Wwf         , Wwf         , Ww          , Ss          , Ww          , Chw         , Khw         , Ww          , Ww          , Ww          , Ww          , Ch          , Rr          , Khw         , Wwf         , Ww          , Ww          
Ww          , Ss          , Wwf         , 1 Khw       , Rr          , Ww          , Ww          , Ww          , Ww          , Re          , Khw         , Chw         , Ww          , Wwf         , Ww          , Gs^Fdf      , Wwf         , Ww          , Ww          , Wo          , Ww          , Ww          , Re          , Gs^Fdf      , Ss^Vhs      , Wwf         , Re          , Chw         , Ds          , Re          , Ur          , Ww          , Re          , Ww          , Wwf         , 2 Khr       , Wwf         , Ss          , Ww          
Ur          , Ww          , Ur          , Khw         , Chr         , Chr         , Ur          , Ww          , Re          , Ww          , Wwf         , Chw         , Gs^Fdf      , Ss          , Ss^Vhs      , Wwf         , Gs^Fdf      , Re          , Md          , Wwr         , Gs^Fdf      , Re          , Cud         , Ur          , Gs^Fdf      , Gs^Fdf      , Re          , Wwf         , Ur          , Uh          , Ur          , Ur          , Ur          , Chr         , Chw         , Khw         , Ds          , Ww          , Ww          
Ur          , Ur          , Ur          , Ur          , Rd          , Ur          , Ur          , Gs^Fdf      , Uh          , Re          , Wwf         , Gs^Fdf      , Ur          , Ur          , Ur          , Ur          , Cud         , Ds          , Ur          , Ur          , Ur          , Ur          , Uh          , Ur          , Ur          , Ur          , Wwf         , Ww^Vm       , Wwf         , Re          , Uu          , Uh          , Md          , Ds          , Rd          , Ur          , Ur          , Ur          , Ur          
Xu          , Uu          , Uu          , Ur          , Rd          , Ds          , Ur          , Uu^Vu       , Uh          , Ur          , Ds          , Wwf         , Wwf         , Uu^Uf       , Xu          , Uh          , Uu          , Ur          , Uu^Uf       , Ur          , Uu^Uf       , Ur          , Uu          , Gs^Fdw      , Xu          , Ds          , Ur          , Re          , Wwf         , Ww          , Gs^Fdf      , Uu^Vud      , Rd          , Rd          , Ur          , Ur          , Uu          , Uu          , Uu          
Xu          , Uh          , Uu          , Ur          , Uh          , Rd          , Rd          , Gs^Fdw      , Gs^Fdw      , Uu          , Ur          , Ds          , Gs^Fdf      , Xu          , Ds          , Wwf         , Uh          , Ur          , Gs^Fdf      , Wwf         , Md          , Ur          , Uh          , Xu          , Xu          , Md          , Gs^Fdf      , Wwf         , Ur          , Re          , Ds          , Rd          , Gs^Fdw      , Uu^Uf       , Ur          , Uu          , Uh          , Uu          , Xu          
Xu          , Xu          , Xu          , Ur          , Uu^Vud      , Uh          , Uu^Uf       , Uu          , Ds          , Md          , Ur          , Ur          , Uu^Uf       , Uu          , Uu^Vud      , Ur          , Ur          , Ur          , Ds          , Rd          , Ds          , Ur          , Ur          , Ur          , Uu^Vud      , Ur          , Ur          , Ur          , Gs^Fdw      , Uh          , Ds          , Rd          , Ur          , Gs^Fdf      , Uu^Vud      , Uu          , Xu          , Uh          , Xu          
Xu          , Xu          , Uu          , Uu          , Gs^Fdw      , Ur          , Ur          , Rd          , Cud         , Uu          , Uu          , Uu^Uf       , Uu          , Gs^Fdw      , Uu          , Cud         , Xu          , Uu^Uf       , Uu          , Rd          , Ur          , Uu          , Cud         , Uu          , Ur          , Gs^Fdw      , Uu^Uf       , Ur          , Uu          , Cud         , Uu          , Rd          , Ur          , Wwf         , Ur          , Xu          , Xu          , Xu          , Xu          
Xu          , Xu          , Xu          , Uu          , Xu          , Uh          , Xu          , Rd          , Xu          , Xu          , Xu          , Gs^Fdw      , Xu          , Uu          , Xu          , Xu          , Xu          , Uu          , Xu          , Rd          , Xu          , Gs^Fdw      , Xu          , Uu          , Xu          , Uu          , Xu          , Uh          , Xu          , Uu          , Xu          , Rd          , Xu          , Xu          , Uh          , Xu          , Xu          , Xu          , Xu          
Xu          , Xu          , Xu          , Xu          , Xu          , Xu          , Xu          , Xu          , Xu          , Xu          , Xu          , Xu          , Xu          , Xu          , Xu          , Xu          , Xu          , Xu          , Xu          , Xu          , Xu          , Xu          , Xu          , Xu          , Xu          , Xu          , Xu          , Xu          , Xu          , Xu          , Xu          , Xu          , Xu          , Xu          , Xu          , Xu          , Xu          , Xu          , Xu          
