border_size=1
usage=map

_off^_usr   , _off^_usr   , _off^_usr   , _off^_usr   , _off^_usr   , _off^_usr   , _off^_usr   , _off^_usr   , _off^_usr   , _off^_usr   , _off^_usr   , _off^_usr   , _off^_usr   , _off^_usr   , _off^_usr   , _off^_usr   , _off^_usr   , _off^_usr   , _off^_usr   , _off^_usr   , _off^_usr   , _off^_usr   , _off^_usr   , _off^_usr   , _off^_usr   , _off^_usr   , _off^_usr   , _off^_usr   , _off^_usr   , _off^_usr   , _off^_usr   , _off^_usr   , _off^_usr   , _off^_usr   , _off^_usr   , _off^_usr   , _off^_usr   , _off^_usr   , _off^_usr   , _off^_usr   
_off^_usr   , _off^_usr   , _off^_usr   , _off^_usr   , _off^_usr   , _off^_usr   , _off^_usr   , _off^_usr   , _off^_usr   , _off^_usr   , _off^_usr   , Gg          , Gg          , Gs^Fms      , Ggf         , Ggf         , Gg          , Gg          , Gg          , Gg          , Gg          , Gg          , Xos         , Xos         , Rp          , Rr          , Rr          , Rr          , Rr          , Rr          , Xos         , Xos         , Gs^Fmw      , Gs^Fmf      , Gs^Fdw      , Gs^Fmf      , Gs^Fmw      , Ss          , Ss          , _off^_usr   
_off^_usr   , _off^_usr   , _off^_usr   , _off^_usr   , _off^_usr   , _off^_usr   , _off^_usr   , _off^_usr   , _off^_usr   , Hh          , Gg          , Ggf         , Ggf         , Gs^Fmf      , Gs^Fmf      , Gs^Fds      , Gs^Fms      , Gg          , Gg          , Xos         , Xos         , Xos         , Gg          , Gg          , Xos         , Xos         , Rp          , Rp          , Rr          , Rp          , Rr          , Rr          , Xos         , Xos         , Gs^Fmw      , Gs^Fdw      , Ss          , Gs^Fdf      , Ss          , _off^_usr   
_off^_usr   , _off^_usr   , _off^_usr   , _off^_usr   , _off^_usr   , Ww          , _off^_usr   , Hh^Fms      , Ww          , Ww          , Hh          , Ggf         , Ggf         , Gs^Fms      , Gs^Fms      , Gg          , Gg          , Rr^Vd       , Gg          , Ggf         , Cv^Xo       , Ggf         , Gg          , Ggf         , Gg          , Gg          , Rp          , Hh^Fmw      , Rp          , Rr          , Rr          , Rp          , Ggf         , Xos         , Gs^Fms      , Gs^Fmw      , Ss          , Gs^Fdw      , Ss          , _off^_usr   
_off^_usr   , _off^_usr   , _off^_usr   , _off^_usr   , Wo          , Ww^Bw\      , Ww          , Gs^Fmf      , Hh          , Hh          , Ww          , Wwf         , Wwf         , Gg          , Gg          , Re          , Re          , Re          , Re          , Re          , Gg          , Gg          , Ggf         , Cv          , Gg          , Gg          , Gg          , Gg          , Xos         , Rp          , Rr          , Rr          , Rp          , Xos         , Gg          , Rd          , Gg          , Gg          , Gs^Fdw      , _off^_usr   
_off^_usr   , _off^_usr   , _off^_usr   , _off^_usr   , Ww          , Ww          , Ggf         , Ggf         , Gs^Fms      , Ggf         , Ggf         , Ggf         , Wwf         , Ww^Bw/      , Re          , Ggf         , Ggf         , Ggf         , Ggf         , Gg          , Cv          , 2 Kv        , Cv          , Wwf         , Cv          , Ggf         , Ggf         , Ggf         , Hh          , Hh^Vhh      , Rp          , Rd          , Rp          , Xos^Dr      , Ss          , Gs^Fmw      , Gg          , Rd          , Gs^Fmw      , _off^_usr   
_off^_usr   , _off^_usr   , _off^_usr   , Ww^Xo       , Ww          , Chw         , Gs^Fds      , Gg          , Gg          , Rp          , Ggf         , Re          , Re          , Rr^Vd       , Wwf         , Wwf         , Ggf         , Gs^Fds      , Gs^Fmf      , Ww          , Gg          , Cv          , Ww          , Ggf         , Ggf         , Ggf         , Gg          , Ggf         , Gg          , Rp          , Rp          , Rd          , Gs^Fdw      , Xos         , Gg          , Gs^Fmw      , Gg^Bw|      , Ss          , Gs^Fmw      , _off^_usr   
_off^_usr   , _off^_usr   , _off^_usr   , Hh          , Ww          , Ww          , Ggf         , Rp          , Rp          , Gs^Fds      , Rp          , Ggf         , Ggf         , Ggf         , Gg          , Ggf         , Ww          , Ww          , Ww          , Ggf         , Gg          , Ggf         , Cv          , Rp          , Ggf         , Ggf         , Gs^Fms      , Gs^Fdf      , Rd          , Rp          , Rd          , Rd          , Rd^Dr       , Xos         , Rd          , Gs^Fmf      , Gs^Bw\      , Rd^Bw\      , Ss          , _off^_usr   
_off^_usr   , _off^_usr   , _off^_usr   , Gg          , Ww          , Ww^Bw/      , Ww^Bw/      , Gg          , Mm          , Hh          , Rp          , Ggf         , Ggf         , Ce          , Ggf         , Ggf         , Ww          , Ww^Vm       , Wwf         , Ggf         , Ggf         , Gg          , Gg          , Ggf         , Rp          , Gg          , Hh          , Hh^Fds      , Xos         , Rp          , Gs^Fdw      , Rd          , Rd          , Xos         , Rd          , Gs^Fmw      , Gs^Fdw      , Gs^Fdw      , Ss^Bw\      , _off^_usr   
_off^_usr   , _off^_usr   , Gg          , Rp          , Rp          , Ww          , Wwf         , Gg          , Hh          , Rr^Vd       , Rp          , Ggf         , Hh          , Ggf         , Ke          , Ce          , Ww          , Wwf         , Wwf         , Gg          , Hh          , Hh          , Hh^Fmf      , Ggf         , Rp          , Rr^Vd       , Gg          , Gg          , Xos         , Rr^Dr       , Rr^Vd       , Rd^Uf       , Rd          , Xos         , Xos         , Xos         , Ss          , Gs^Fdw      , Ss          , _off^_usr   
_off^_usr   , Gg          , Rp          , Gg          , Hh          , Ww          , Wwf         , Ggf         , Gg          , Re          , Re          , Gs^Fmf      , Gg          , Ggf         , Gs^Fms      , Ggf         , Ggf         , Wwf         , Ggf         , Ggf         , Ggf         , Gg          , Gs^Fmw      , Gg          , Re          , Wwf         , Ggf         , Ggf         , Gg          , Rp          , Rr          , Rr          , Rd          , Xos         , Rd^Uf       , Rr          , Xos         , Xos         , Gs^Fdw      , _off^_usr   
_off^_usr   , Xos         , Gg          , Gg          , Ggf         , Ww          , Wwf         , Ggf         , Ggf         , Rp          , Re          , Chr         , Hh          , Hh          , Gg          , Ggf         , Gg          , Ww          , Ggf         , Hh^Vhh      , Gg          , Gg          , Ss          , Wwf         , Wwf         , Gg          , Ggf         , Gs^Fmf      , Re          , Rp          , Rr          , Rp          , Rp          , Rp          , Rp^Dr       , Rp          , Rr          , Rr          , Xos         , _off^_usr   
_off^_usr   , Rr          , Xos         , Hh          , Ggf         , Wwf         , Wwf         , Wwf         , Ggf         , Rp          , Hh          , Hh^Fmf      , Gg          , Mm          , Hh          , Ggf         , Ggf         , Wwf         , Ggf         , Ggf         , Hh          , Wwf         , Wwf         , Gg          , Rp          , Ggf         , Mm          , Hh          , Xos         , Rp          , Rp          , Rr          , Rp          , Rp          , Rp          , Rp          , Rr          , Ggf         , Ggf         , _off^_usr   
_off^_usr   , Rr          , Xos         , Xos         , Gg          , Wwf         , Gs^Fms      , Hh          , Wwf         , Ww^Bw|      , Ggf         , Ggf         , Gs^Fms      , Ggf         , Ggf         , Wwf         , Wwf         , Xos         , Wo          , Ww          , Wwf         , Ggf         , Gg          , Ggf         , Re          , Rd          , Ggf         , Gg          , Rp          , Rp          , Rp          , Rr          , Ch          , Xos         , Rr          , Rr          , Rp          , Rp          , Gg          , _off^_usr   
_off^_usr   , Rr          , Rr          , Xos         , Gg          , Ggf         , Chr         , Mm          , Gg          , Re          , Wwf         , Wwf         , Ggf         , Ggf         , Ggf         , Wo          , Xos         , Gg^Fet      , Xos         , Wo          , Wwf         , Gs^Fdw      , Hh          , Gs^Fmw      , Chr         , Rd          , Ggf         , Ch          , Ggf         , Rp          , Rp          , Rr          , Chr         , Rr          , Rr          , Rp          , Rp          , Rp          , Gg          , _off^_usr   
_off^_usr   , Rr          , Rr          , Xos         , Gg          , Gg          , Gg          , Ggf         , Gg^Fet      , Rp          , Gg          , Gg          , Wwf         , Wwf         , Ww          , Wo          , Ww^Xo       , Cv          , Ww^Xo       , Wo          , Wwf         , Gs^Fdw      , Ss          , Mm          , Hh^Fms      , Rd          , Gg^Fet      , Ch          , Xos         , Rp          , Rp          , Rp          , Rp          , Rr          , Rr          , Rp          , Rp          , Ggf         , Gg          , _off^_usr   
_off^_usr   , Rr          , Rr          , Xos         , Ggf         , Ggf         , Ggf         , Ggf         , Ggf         , Re          , Gg          , Ggf         , Ggf         , Hh^Vhh      , Wwr         , Wwf         , Xos         , Xos         , Xos         , Ww          , Wwf         , Hh          , Gs          , Ggf         , Re          , Ggf         , Ggf         , Gg          , Rp          , Rp          , Rp          , Rr          , Chr         , Xos         , Rp^Uf       , Rp          , Rp          , Rp          , Ggf         , _off^_usr   
_off^_usr   , Rr          , Rr          , Xos         , Hh          , Ggf         , Ggf         , Gg          , Gg          , Re          , Hh          , Gs^Fmf      , Ggf         , Gg          , Hh          , Hh^Fdw      , Wwf         , Wwf         , Wo          , Gg          , Wwf         , Wwf         , Gg          , Ggf         , Rp          , Ggf         , Ggf         , Hh          , Rp          , Rr          , Rr          , Rr          , Ch          , Rp          , Rp          , Rp          , Rp          , Ggf         , Ggf         , _off^_usr   
_off^_usr   , Rr          , Rr          , Xos         , Hh          , Ggf         , Ggf         , Gg          , Rr^Vd       , Re          , Gs^Fms      , Hh^Fms      , Mm          , Ggf         , Ggf         , Rd          , Wwf         , Wwf         , Ggf         , Gg          , Ggf         , Gg          , Wwf         , Wwf         , Wwf         , Rr^Vd       , Gs^Fms      , Hh          , Xos         , Rd          , Rd          , Rp          , Rp          , Rp          , Rp          , Rr          , Rr          , Rr          , Ggf         , _off^_usr   
_off^_usr   , Rr          , Rr          , Rr          , Xos         , Mm          , Ggf         , Gg          , Ggf         , Rp          , Ggf         , Ggf         , Hh          , Ggf         , Ggf         , Rd          , Ss          , Wwf         , Gg          , Hh          , Gs^Fms      , Gs^Fmf      , Ggf         , Ggf         , Wwf         , Wwf         , Ggf         , Ggf         , Gg          , Re          , Rd^Uf       , Rr^Vd       , Rp^Dr       , Xos         , Rp          , Rr          , Rr          , Xos         , Xos         , _off^_usr   
_off^_usr   , Rr          , Rr          , Rr          , Xos         , Hh          , Ggf         , Gs^Fmf      , Hh          , Rp          , Ggf         , Ggf         , Ce          , Ke          , Ggf         , Gg          , Gg          , Wwf         , Gg          , Ggf         , Gg          , Hh          , Mm          , Gg          , Re          , Ggf         , Ggf         , Gs^Fmf      , Ggf         , Rp          , Rp          , Gs^Fdw      , Rd          , Xos         , Rr          , Xos         , Xos         , Gg          , Gg          , _off^_usr   
_off^_usr   , Rr          , Rr          , Rr          , Xos         , Gg          , Ggf         , Gs^Fmf      , Hh^Fms      , Rp          , Ggf         , Ggf         , Ggf         , Gg          , Ce          , Ww          , Wwf         , Ww^Vm       , Ggf         , Ggf         , Gg          , Ggf         , Gg          , Ggf         , Re          , Ggf         , Hh          , Uh          , Xu          , Rp          , Rp          , Rr          , Rd          , Xos         , Xos         , Gg          , Gg          , Gg          , Gg          , _off^_usr   
_off^_usr   , Rr          , Rr          , Rr          , Xos         , Gg          , Ggf         , Ggf         , Hh          , Rp          , Ggf         , Ggf         , Ggf         , Ggf         , Gg          , Gg          , Ww          , Ww          , Wwf         , Ggf         , Gg          , Cv          , Cv          , Cv          , Re          , Ggf         , Gs^Fms      , Ur          , Ur          , Rd          , Rp          , Rr          , Rp          , Xos         , Gg          , Gg          , Gg          , Re^Gvs      , Re^Gvs      , _off^_usr   
_off^_usr   , Rr          , Rr          , Rr          , Xos         , Gg          , Ggf         , Ggf         , Gg          , Gg          , Rp          , Re          , Rr^Vd       , Ggf         , Ggf         , Ggf         , Gg          , Gg          , Wwf         , Gg          , Cv          , Gg          , 1 Kv        , Gg          , Cv          , Ggf         , Ggf         , Gg          , Xu          , Rd          , Rp          , Rd          , Rp^Dr       , Xos         , Gg          , Re^Gvs      , Re^Gvs      , Gg^Wm       , Re^Gvs      , _off^_usr   
_off^_usr   , _off^_usr   , Rr          , Xos         , Xos         , Gg          , Gg          , Gs^Fmf      , Ggf         , Gs^Fmf      , Gg          , Ggf         , Rp          , Rp          , Ggf         , Gg          , Gs^Fms      , Hh          , Hh          , Ggf         , Ggf         , Rp          , Cv          , Gg          , Gg          , Ggf         , Ggf         , Ggf         , Rd^Dr       , Hh^Vhh      , Rp          , Rp          , Gs^Fdw      , Xos         , Gg          , Re^Gvs      , Re^Gvs      , Re^Gvs      , Re^Gvs      , _off^_usr   
_off^_usr   , _off^_usr   , _off^_usr   , _off^_usr   , Ggf         , Re^Gvs      , Re^Gvs      , Re^Gvs      , Gs^Fms      , Gs^Fmf      , Gs^Fds      , Ggf         , Ggf         , Gg          , Re          , Re          , Gg          , Rr^Vd       , Ggf         , Re          , Re          , Ggf         , Ggf         , Gg          , Ggf         , Gs^Fms      , Gg          , Gg          , Gg          , Rp          , Rp          , Rr          , Rd          , Xos         , Gg          , Re^Gvs      , Re^Gvs      , Re^Gvs      , Re^Gvs      , _off^_usr   
_off^_usr   , _off^_usr   , _off^_usr   , _off^_usr   , _off^_usr   , _off^_usr   , Re^Gvs      , Re^Gvs      , Re^Gvs      , Ggf         , Gs^Fms      , Ggf         , Gg          , Gg          , Gg          , Gg          , Re          , Rp          , Rp          , Ggf         , Ggf         , Cv^Xo       , Ggf         , Ggf         , Gs^Fds      , Gs^Fmf      , Gg          , Rr          , Xos         , Rr          , Rr          , Ggf         , Gg          , Xos         , Gg          , Re^Gvs      , Re^Gvs      , Re^Gvs      , Re^Gvs      , _off^_usr   
_off^_usr   , _off^_usr   , _off^_usr   , _off^_usr   , _off^_usr   , _off^_usr   , _off^_usr   , _off^_usr   , Gg^Wm       , _off^_usr   , Re^Gvs      , Re^Gvs      , Ggf         , Gs^Fmf      , Gs^Fms      , Rr          , Ggf         , Rr          , Ggf         , Ggf         , Xos         , Xos         , Xos         , Gg          , Hh^Fds      , Xos         , Rp          , Rp          , Rp          , Rp          , Rr          , Rp          , Rp          , Xos         , Gg          , Re^Gvs      , Gg^Wm       , Re^Gvs      , Re^Gvs      , _off^_usr   
_off^_usr   , _off^_usr   , _off^_usr   , _off^_usr   , _off^_usr   , _off^_usr   , _off^_usr   , _off^_usr   , _off^_usr   , _off^_usr   , _off^_usr   , _off^_usr   , Ggf         , Rr          , Rr          , Rr          , Rr          , Rr          , Rr          , Rr          , Ggf         , Ggf         , Gg          , Xos         , Xos         , Rp          , Rr          , Rr          , Rr          , Rr          , Rp          , Xos         , Xos         , Gg          , Gg          , Re^Gvs      , Re^Gvs      , Re^Gvs      , Re^Gvs      , _off^_usr   
_off^_usr   , _off^_usr   , _off^_usr   , _off^_usr   , _off^_usr   , _off^_usr   , _off^_usr   , _off^_usr   , _off^_usr   , _off^_usr   , _off^_usr   , _off^_usr   , _off^_usr   , _off^_usr   , _off^_usr   , _off^_usr   , _off^_usr   , _off^_usr   , _off^_usr   , _off^_usr   , _off^_usr   , _off^_usr   , _off^_usr   , _off^_usr   , _off^_usr   , _off^_usr   , _off^_usr   , _off^_usr   , _off^_usr   , _off^_usr   , _off^_usr   , _off^_usr   , _off^_usr   , _off^_usr   , _off^_usr   , _off^_usr   , _off^_usr   , _off^_usr   , _off^_usr   , _off^_usr   
