border_size=1
usage=map

Ss          , Gs^Fp       , Gs^Fp       , Gg          , Gg          , Gg          , Gg          , Gs          , Re^Gvs      , Re^Gvs      , Re^Gvs      , Re^Gvs      , Re^Gvs      , Re^Gvs      , Re^Gvs      , Re^Gvs      , Re^Gvs      , Re^Gvs      , Re^Gvs      , Re^Gvs      , Re^Gvs      , Re^Gvs      , Re^Gvs      , Re^Gvs      , Re^Gvs      , Re^Gvs      , Re^Gvs      , Re^Gvs      , Mm^Xm       , Mm^Xm       , Ww          , Gg          , Ww          , Wo          
Gs^Fp       , Ss          , Ss          , Gg          , Gg          , Gg          , Gg          , Gg          , Ch          , Ch          , Ch          , Gg          , Gg          , Re^Gvs      , Ggf         , Gg          , Gg^Wm       , Gg          , Gg^Ve       , Re^Gvs      , Mm          , Re^Gvs      , Re^Gvs      , Re^Gvs      , Re^Gvs      , Re^Gvs      , Ss          , Gg          , Ww          , Ww          , Ww          , Ww          , Wo          , Wo          
Gg          , Gs^Fp       , Gg^Vc       , Gg          , Gg          , Gg          , Gg          , Gg          , Ch          , 1 Kh        , Ch          , Gg          , Gg          , Gg          , Gg          , Gg          , Gg          , Gg          , Gg          , Gg          , Gg          , Gg          , Gg          , Re^Vct      , Gg          , Gg          , Gg          , Ce          , Ww          , Ww          , Ww          , Wo          , Wo          , Wo          
Gg          , Gg          , Gg          , Gg          , Gg          , Gg          , Gg          , Gg          , Rd          , Ch          , Gg          , Rr          , Rr          , Gg          , Gs^Fp       , Gg          , Gg          , Hh^Fds      , Gg          , Hh^Fdf      , Gg          , Gg          , Mm          , Gg          , Gg          , Gg^Wm       , Gg          , Gg          , Mm^Xm       , Ww          , Ww          , Wo          , Wo          , Wo          
Mm          , Gg          , Gg          , Gg^Wm       , Gg          , Gg          , Gg          , Gg          , Rd          , Gg          , Hh          , Gg          , Gg          , Rr          , Mm          , Gg          , Gg          , Ggf         , Gg          , Gg          , Ggf         , Gs^Fp       , Gg          , Gg          , Wwr         , Gg          , Ww          , Ww          , Mm^Xm       , Mm^Xm       , Ww          , Wo          , Wo          , Wo          
Mm          , Gs^Fp       , Gg          , Gg          , Gg          , Gg^Ve       , Hh^Fds      , Gs^Fp       , Rd          , Mm          , Gs^Fp       , Gg          , Gg          , Rr          , Rr          , Ww          , Ww          , Gg          , Gg          , Gg          , Gg          , Gg^Ve       , Gg          , Wwr         , Ww          , Ww          , Ww          , Mm^Xm       , Mm^Xm       , Wwr         , Ww          , Wo          , Wo          , Wo          
Mm          , Hh          , Gg          , Ggf         , Gg^Fet      , Gs^Fp       , Mm          , Rd          , Gg          , Gg          , Gg          , Gg          , Gg          , Rp^Vhc      , Ww          , Ww^Bw\      , Ww          , Gs^Fp       , Ss          , Gg          , Gg          , Ss          , Gg          , Gg          , Ww          , Ww          , Mm^Xm       , Mm^Xm       , Mm          , Ww          , Wo          , Wo          , Wo          , Wo          
Gg          , Gg          , Gg          , Gg          , Gg          , Hh^Fds      , Gg          , Rd          , Gg          , Gg          , Ggf         , Gg          , Hh^Fds      , Ss          , Ww          , Ww^Bw|      , Ww          , Gg^Fet      , Wwf         , Wwf         , Ww          , Ww          , Ww          , Gg          , Ch          , Ww          , Ww          , Mm          , Md          , Ww          , Wo          , Wo          , Wo          , Wo          
Gg          , Ggf         , Hh^Fms      , Mm          , Gg          , Gg          , Gg^Vh       , Rd          , Gg          , Hh^Fds      , Hh^Fds      , Gg          , Ss          , Hh^Fds      , Gg          , Rr          , Rd          , Ww          , Rd          , Ww          , Ww          , Ww          , Ww          , Ww          , Ww          , Ww          , Ww          , Ww          , Ww          , Ww          , Wo          , Wo          , Wo          , Wo          
Gg          , Gg          , Hh^Fms      , Hh^Fms      , Gs^Fp       , Ggf         , Rd          , Rd          , Gg          , Gs^Fp       , Gg          , Gg          , Gs^Fp       , Mm          , Gg          , Rr          , Gg          , Rd          , Gg^Ve       , Rd          , Rd          , Ww          , Gg          , Ww          , Ww          , Ww          , Wo          , Wo          , Wo          , Wo          , Wo          , Wo          , Wo          , Wo          
Gg          , Gg          , Hh^Vc       , Gg          , Ggf         , Ss          , Rd          , Gg          , Gg^Wm       , Gg          , Gg          , Ss          , Gg          , Gg          , Ss          , Rr          , Rr          , Gs^Fp       , Gg          , Gg          , Rd          , Gg          , Ch          , Ch          , Ww          , Wo          , Wo          , Wo          , Ww          , Ww          , Wwr         , Wwr         , Wwr         , Wo          
Gg          , Gg          , Gg          , Gg          , Gg          , Rd          , Gg          , Gg          , Gg          , Gg          , Gg          , Ss^Vhs      , Gg          , Gg          , Hh          , Ss          , Rr          , Gg          , Ss          , Gg          , Ch          , Kh          , Ww^Bw\      , Ww          , Ww          , Ww          , Ww          , Ww          , Mm          , Wwr         , Gg          , Chw         , Wwr         , Wo          
Gg          , Gg          , Gg          , Ggf         , Rd          , Rd          , Gg          , Mm          , Gs^Fp       , Gs^Fp       , Gg          , Gg          , Gs^Fp       , Gg          , Gg          , Ss          , Rr          , Gg          , Gg          , Gg          , Ww          , Ww          , Ww          , Ww^Bw|      , Gg          , Ww^Vm       , Gg          , Ggf         , Gg          , Hh          , Gs^Vht      , Wwf         , Ww          , Wo          
Gg          , Gg          , Ce          , Ce          , Ce          , Ke          , Ce          , Mm^Xm       , Mm^Xm       , Mm          , Mm^Xm       , Gg          , Cud         , Cud         , Cud         , Rr          , Gg          , Gg          , Gg          , Gg          , Ww          , Wo          , Ww          , Rd          , Rd          , Gs^Fp       , Gg          , Hh          , Wwf         , Gg          , Ww          , Ww          , Wo          , Wo          
Gg          , Gg          , Gs^Fp       , Gg          , Rd          , Gg          , Gs^Fp       , Mm^Xm       , Hh^Fds      , Mm^Xm       , Mm^Xm       , Mm^Xm       , Cud         , Kud         , Cud         , Rr          , Gg          , Gg          , Ww          , Ch          , Ww          , Wo          , Ww          , Gs^Fp       , Mm^Xm       , Rd          , Hh^Fds      , Gg          , Gg          , Gs^Fp       , Gg          , Wwr         , Wo          , Wo          
Gg          , Gg          , Gs^Vht      , Rd          , Gg          , Gg          , Gg          , Gg          , Gg          , Gg          , Mm^Xm       , Qxu         , Xu          , Cud         , Ur          , Ur          , Ur          , Cud         , Ww          , Ww          , Ww          , Wo          , Mm^Xm       , Mm^Xm       , Hh          , Rd          , Gg^Vh       , Gg          , Gg          , Wwf         , Ww          , Wwr         , Wo          , Wo          
Gs^Fp       , Gg          , Rd          , Rd          , Gg          , Hh^Fds      , Gg          , Gg          , Gg          , Gg^Ve       , Gg          , Xu          , Ur          , Ur          , Uu^Uf       , Ur          , Wwf         , Wwf         , Wwf         , Ww          , Mm^Xm       , Ww          , Mm^Xm       , Gg          , Rd          , Rd          , Ggf         , Ss          , Wwf         , Ww          , Ww          , Wo          , Wo          , Wo          
Hh          , Gg^Fet      , Rd          , Gs^Fmf      , Gg          , Gg          , Ww          , Hh^Fds      , Gg          , Gg          , Gg          , Cud         , Ur          , Uu^Vud      , Uh          , Cud         , Ww^Bw\      , Wwf         , Ur          , Xu          , Xu          , Mm^Xm       , Uu^Ufi      , Rd          , Hh^Fds      , Gg          , Gs^Fp       , Gg          , Ggf         , Gg          , Ww          , Wo          , Wo          , Wo          
Mm^Xm       , Ss          , Hh          , Rd          , Gg          , Aa          , Ai          , Uu^Ufi      , Uu          , Gs^Fp       , Mm^Xm       , Mm^Xm       , Xu          , Xu          , Xu          , Ww          , Wo          , Wo^Bw\      , Uu          , Uu^Uf       , Xu          , Mm^Xm       , Ss          , Rd          , Rd          , Gs^Fp       , Mm^Xm       , Uh          , Mm^Xm       , Wwf         , Wwf         , Ww          , Wo          , Wo          
Mm^Xm       , Hh^Fp       , Hh          , Rd          , Gg          , Ms          , Ai          , Hh^Fds      , Uu          , Uu^Ufi      , Mm^Xm       , Qxu         , Xu          , Qlf         , Xu          , Wo          , Wo          , Hh          , Uu          , Gs^Fdf      , Xu          , Mm^Xm       , Ss          , Mm          , Rd          , Mm          , Mm^Xm       , Uh          , Mm^Xm       , Hh          , Wwf         , Ww          , Wo          , Wo          
Hh          , Ss          , Rd          , Rd          , Gg          , Aa          , Ww          , Uu^Ufi      , Gg          , Gs^Fp       , Gg          , Mm^Xm       , Ur          , Xu          , Uh          , Ww          , Ww^Bw/      , Wo^Bw/      , Ur          , Uu^Uf       , Xu          , Mm^Xm       , Uu^Ufi      , Rd          , Hh^Fds      , Gs^Fp       , Gs^Fp       , Uh          , Ggf         , Wwf         , Ww          , Ww          , Wo          , Wo          
Gs^Fp       , Gs^Fp       , Rd          , Gs^Fmf      , Gg          , Gg          , Gg          , Hh^Fds      , Gg          , Gg          , Gg          , Cud         , Ur          , Uu^Vu       , Uu^Uf       , Cud         , Wwf         , Wwf         , Wwf         , Xu          , Mm^Xm       , Mm^Xm       , Mm^Xm       , Rd          , Rd          , Gg          , Gg          , Gg          , Wwf         , Gg          , Ww          , Wo          , Wo          , Wo          
Gg          , Gg          , Gs^Vht      , Rd          , Gg          , Hh^Fds      , Gg          , Gg          , Gg          , Re^Vct      , Mm^Xm       , Xu          , Xu          , Ur          , Ur          , Ur          , Ur          , Wwf         , Ww          , Ww          , Ww          , Ww          , Mm^Xm       , Gg          , Hh          , Rd          , Gg^Vh       , Ss          , Gg          , Ww          , Ww          , Wo          , Wo          , Wo          
Gg          , Gg          , Gs^Fp       , Rd          , Rd          , Gg          , Gs^Fp       , Gg          , Hh^Fds      , Gg          , Mm^Xm       , Qxu         , Cud         , Cud         , Cud         , Ur          , Gg          , Cud         , Ww          , Ww          , Ww          , Wo          , Ww          , Mm^Xm       , Mm^Xm       , Rd          , Hh^Fds      , Gg          , Ss          , Wwf         , Ggf         , Wwr         , Wo          , Wo          
Gg          , Gg          , Ce          , Gg          , Ce          , Gg          , Ce          , Mm^Xm       , Mm^Xm       , Mm^Xm       , Mm^Xm       , Mm^Xm       , Cud         , Kud         , Cud         , Rr          , Gg          , Gg          , Gg          , Ch          , Ww          , Wo          , Ww          , Gs^Fp       , Rd          , Rd          , Gg          , Gg          , Wwf         , Gs^Fp       , Ww          , Wwr         , Wo          , Wo          
Gg          , Gg          , Gg          , Ce          , Rd          , Ke          , Gg          , Mm^Xm       , Gs^Fp       , Mm          , Gg          , Gg          , Gs^Fp       , Cud         , Gg          , Rr          , Rr          , Gg          , Gg          , Gg          , Ww          , Wo          , Ww          , Rd          , Gg          , Gs^Fp       , Gg          , Hh          , Gg          , Gg          , Gs^Vht      , Ww          , Ww          , Wo          
Gg          , Gg          , Gg          , Ggf         , Gg          , Rd          , Gg          , Mm          , Gg          , Gg^Fet      , Gg          , Gg          , Gg          , Gg          , Hh          , Ss          , Rr          , Gg          , Ss          , Gg          , Ch          , Ww          , Wwr^Bw/     , Ww^Bw|      , Ww          , Ww^Vm       , Ww          , Ggf         , Mm          , Hh          , Gg          , Wwf         , Wwr         , Wo          
Gg          , Gg          , Hh^Vc       , Gg          , Gg          , Rd          , Rd          , Gg          , Gg^Wm       , Gg          , Gg          , Ss^Vhs      , Gg          , Gg          , Ss          , Ss          , Rr          , Gg          , Gg          , Gg          , Rd          , Kh          , Ch          , Ww          , Ww          , Ww          , Wo          , Ww          , Ww          , Wwr         , Wwr         , Chw         , Wwr         , Wo          
Gg          , Gg          , Hh^Fds      , Gg          , Gs^Fp       , Ss          , Rd          , Gg          , Gg          , Gg          , Gg          , Ss          , Gs^Fp       , Gg          , Gg          , Rr          , Gg          , Gs^Fp       , Gg^Ve       , Gg          , Rd          , Gg          , Gg          , Ch          , Ww          , Wo          , Wo          , Wo          , Wo          , Ww          , Wo          , Wwr         , Wo          , Wo          
Gg          , Gg          , Hh^Fds      , Hh^Fds      , Gg          , Ggf         , Gg^Vh       , Rd          , Gg          , Gs^Fp       , Hh^Fds      , Gg          , Ss          , Mm          , Gg          , Rr          , Rd          , Rd          , Rd          , Rd          , Ww          , Ww          , Ww          , Ww          , Ww          , Ww          , Ww          , Wo          , Ww          , Wo          , Wo          , Wo          , Wo          , Wo          
Gg          , Gg          , Gg          , Mm          , Gg          , Gg          , Gg          , Rd          , Gg          , Hh^Fds      , Gg          , Gg          , Hh^Fmw      , Hh^Fmw      , Ww          , Rr          , Ww          , Ww          , Wwf         , Ww          , Ww          , Ww          , Ww          , Ww          , Ch          , Ww          , Ww          , Ww          , Md          , Ww          , Wo          , Wo          , Wo          , Wo          
Mm          , Gg          , Gg          , Gg          , Gg^Fet      , Hh^Fds      , Mm          , Rd          , Gg          , Gg          , Gg          , Ggf         , Gg          , Ss          , Ww          , Ww^Bw|      , Ww          , Gs^Fp       , Ss          , Wwf         , Gg          , Ww          , Gg          , Gg          , Ww          , Ww          , Mm^Xm       , Mm          , Mm          , Ww          , Wo          , Wo          , Wo          , Wo          
Mm          , Hh          , Gg          , Gg          , Gg          , Gs^Fp       , Hh^Fds      , Rd          , Rd          , Gg          , Gs^Fp       , Gg          , Gg          , Rp^Vhc      , Rr          , Ww^Bw/      , Ww          , Gs^Fp       , Gg          , Gg          , Gg          , Ss          , Gg          , Gg          , Ww          , Ww          , Ww          , Mm^Xm       , Mm^Xm       , Ww          , Wo          , Wo          , Wo          , Wo          
Mm          , Gs^Fp       , Gg          , Gg          , Gg          , Gg^Ve       , Gg          , Gs^Fp       , Rd          , Mm          , Hh          , Gg          , Gg          , Rr          , Mm          , Ww          , Gg          , Gg          , Gg          , Ggf         , Gg          , Gg^Ve       , Gg          , Wwr         , Wwr         , Ww          , Ww          , Mm^Xm       , Mm^Xm       , Wwr         , Ww          , Wo          , Wo          , Wo          
Gg          , Gg          , Gg          , Gg^Wm       , Gg          , Gg          , Gg          , Gg          , Rd          , Gg          , Gg          , Gg          , Rr          , Rr          , Gs^Fp       , Gg          , Ggf         , Gg          , Gg          , Ggf         , Gg          , Gs^Fp       , Mm          , Ggf         , Gg          , Gg          , Ggf         , Ww          , Mm^Xm       , Mm^Xm       , Ww          , Wo          , Wo          , Wo          
Gg          , Gg          , Gg^Vc       , Gg          , Gg          , Gg          , Ggf         , Gg          , Ch          , Ch          , Ch          , Rr          , Gg          , Gg          , Gg          , Gg          , Gg          , Hh^Fds      , Gg          , Hh^Fdf      , Gg          , Gg          , Gg          , Gg          , Gg          , Gg^Wm       , Gg          , Gg          , Ww          , Ww          , Ww          , Wo          , Wo          , Wo          
Gs^Fp       , Gs^Fp       , Ss          , Gg          , Gg          , Gg          , Gg          , Gg          , Ch          , 2 Kh        , Ch          , Gg          , Re^Gvs      , Gg          , Gg          , Gg          , Gg^Wm       , Gg          , Gg^Ve       , Gg          , Mm          , Gg          , Re^Gvs      , Re^Vct      , Re^Gvs      , Gg          , Ss          , Ce          , Ww          , Ww          , Ww          , Ww          , Wo          , Wo          
Ss          , Ss          , Gs^Fp       , Gg          , Gg          , Gg          , Gg          , Ggf         , Re^Gvs      , Ch          , Re^Gvs      , Re^Gvs      , Re^Gvs      , Re^Gvs      , Re^Gvs      , Gg          , Re^Gvs      , Re^Gvs      , Re^Gvs      , Re^Gvs      , Re^Gvs      , Re^Gvs      , Re^Gvs      , Re^Gvs      , Re^Gvs      , Re^Gvs      , Re^Gvs      , Gg          , Mm^Xm       , Ww          , Ww          , Ww          , Wo          , Wo          
Ss          , Gs^Fp       , Gg          , Gg          , Gg          , Gg          , Gg          , Gg          , Gg          , Re^Gvs      , Re^Gvs      , Re^Gvs      , Re^Gvs      , Re^Gvs      , Re^Gvs      , Re^Gvs      , Re^Gvs      , Re^Gvs      , Re^Gvs      , Re^Gvs      , Re^Gvs      , Re^Gvs      , Re^Gvs      , Re^Gvs      , Re^Gvs      , Re^Gvs      , Re^Gvs      , Re^Gvs      , Re^Gvs      , Mm^Xm       , Mm^Xm       , Ww          , Ww          , Wo          
