border_size=1
usage=map

Xv          , Xv          , Xv          , Xv          , Xv          , Xv          , Xv          , Xv          , Xv          , Xv          , Xv          , Xv          , Xv          , Xv          , Xv          , Xv          , Xv          , Xv          , Xv          , Xv          , Xv          , Xv          , Xv          , Xv          , Xv          , Xv          , Xv          , Xv          , Xv          , Xv          , Xv          , Xv          , Xv          , Xv          , Xv          
Xv          , Xv          , Xv          , Xv          , Xv          , Xv          , Xv          , Xv          , Xv          , Xv          , Xv          , Xv          , Dd^Vda      , Xv          , Xv          , Xv          , Gs^Fdw      , Gs^Fdf      , Gs^Fdf      , Xv          , Xv          , Xv          , Gs^Fp       , Xv          , Xv          , Xv          , Xv          , Xv          , Xv          , Xv          , Xv          , Xv          , Xv          , Xv          , Xv          
Xv          , Xv          , Xv          , Xv          , Xv          , Xv          , Xv          , Xv          , Xv          , Xv          , Ds          , Ds          , Re          , Re          , Re          , Gs^Fdf      , Ss          , Gs^Fdw      , Ss          , Gs^Fdw      , Ds          , Gg          , Gg          , Gs^Fdf      , Gs^Fp       , Xv          , Xv          , Xv          , Xv          , Xv          , Xv          , Xv          , Xv          , Xv          , Xv          
Xv          , Xv          , Xv          , Xv          , Xv          , Xv          , Xv          , Xv          , Dd^Dc       , Ds          , Gg          , Dd          , Re          , Re          , Re          , Re          , Re          , Gs^Fdf      , Wwf         , Wwf         , Wwf         , Gg          , Gg          , Gg^Ve       , Gs^Fdf      , Gs^Fmf      , Gs^Fmf      , Xv          , Xv          , Xv          , Xv          , Xv          , Xv          , Xv          , Xv          
Xv          , Xv          , Xv          , Xv          , Xv          , Xv          , Xv          , Xv          , Ds          , Gg          , Gs^Fmf      , Gs^Fmf      , Gg          , Gs^Fmf      , Gg          , Gg          , Wwf         , Wwf         , Gg          , Gg          , Gg          , Wwf         , Wwf         , Gg          , Gg          , Gs^Fp       , Gs^Fdf      , Xv          , Xv          , Xv          , Xv          , Xv          , Xv          , Xv          , Xv          
Xv          , Xv          , Xv          , Xv          , Xv          , Xv          , Xv          , Xv          , Hh          , Gg          , Gg          , Gg          , Gg          , Gg^Ve       , Gg          , Gg          , Wwf         , Chw         , Gg          , Gg          , Gg          , Gg          , Chw         , Wwf         , Wwf         , Gg          , Hh          , Xv          , Xv          , Xv          , Xv          , Xv          , Xv          , Xv          , Xv          
Xv          , Xv          , Xv          , Xv          , Xv          , Xv          , Re^Gvs      , Re^Gvs      , Gg^Ve       , Gg          , Gg          , Gg          , Gg          , Ss          , Wwf         , Wwf         , Chr         , Chr         , Chr         , Gg          , Gg          , Gg          , Ggf         , Gg          , Wwf         , Gg          , Gg          , Mm          , Gs^Fdw      , Xv          , Xv          , Xv          , Xv          , Xv          , Xv          
Xv          , Xv          , Xv          , Xv          , Xv          , Gs          , Hh          , Gs^Fp       , Ss          , Gg          , Gg          , Re^Gvs      , Wwf         , Wwf         , Gg          , Chw         , Gg          , 2 Khr       , Gg          , Chr         , Gs^Fdf      , Gg          , Gg          , Gg          , Wwf         , Hh          , Gs^Fdf      , Gg          , Gg          , Gs^Fdf      , Xv          , Xv          , Xv          , Xv          , Xv          
Xv          , Xv          , Xv          , Xv          , Xv          , Gs^Fdf      , Gs          , Ss          , Re          , Re          , Gs          , Re^Gvs      , Wwf         , Ggf         , Ggf         , Gg          , Ww          , Chw         , Re^Gvs      , Ggf         , Re          , Gg          , Ggf         , Gg          , Gg          , Wwf         , Wwf         , Gg          , Gg          , Gs^Fdw      , Xv          , Xv          , Xv          , Xv          , Xv          
Xv          , Xv          , Xv          , Xv          , Xv          , Gs^Fdf      , Ss          , Re          , Re          , Re          , Re          , Re          , Wwf         , Gg^Fet      , Ww          , Ww          , Ww          , Ww          , Re^Gvs      , Re          , Gs^Fdf      , Re          , Gg          , Gg          , Re          , Gg^Ve       , Wwf         , Gg          , Gg          , Gs^Fdf      , Xv          , Xv          , Xv          , Xv          , Xv          
Xv          , Xv          , Xv          , Xv          , Xv          , Gs^Fdf      , Ss          , Re          , Re          , Re          , Gs^Fdf      , Ds          , Re^Gvs      , Wwf         , Gg          , Re          , Re          , Re^Gvs      , Re          , Re          , Ss          , Re          , Re          , Hh          , Ds          , Re          , Wwf         , Gg          , Gg          , Gs^Fdf      , Xv          , Xv          , Xv          , Xv          , Xv          
Xv          , Xv          , Xv          , Xv          , Gs^Fdf      , Hh^Fdf      , Re          , Re          , Ds^Dr       , Re          , Gs^Fdf      , Gs^Fdf      , Re          , Wwf         , Gg^Vh       , Re          , Re          , Re          , Wwf         , Wwf         , Re^Gvs      , Wwf         , Ss          , Re^Gvs      , Ss          , Wwf         , Gg          , Wwf         , Re          , Re          , Ss          , Xv          , Xv          , Xv          , Xv          
Xv          , Xv          , Gs^Fdf      , Hh^Fdf      , Ss          , Ss          , Re          , Re          , Ke          , Gs^Fdf      , Ds          , Hd          , Ds          , Wwf         , Wwf         , Re^Gvs      , Wwf         , Wwf         , Gs^Vht      , Gs          , Ggf         , Gs          , Re^Gvs      , Ss          , Gg          , Mm          , Gg          , Wwf         , Re          , Mm          , Gs^Fp       , Ss          , Ss          , Xv          , Xv          
Xv          , Xv          , Gs^Fdf      , Ss          , Re          , Gg^Vh       , Re          , Re          , Re          , Ce          , Re          , Ds          , Re          , Re^Gvs      , Wwf         , Wwf         , Re          , Gg          , Re          , Ggf         , Ds          , Chr         , Gs          , Ss          , Hh          , Gg          , Gg          , Wwf         , Wwf         , Re          , Re          , Re          , Ss          , Xv          , Xv          
Xv          , Xv          , Hh^Fdf      , Re          , Re          , Re          , Ss          , Hh          , Re          , Re          , Gs          , Gs          , Ww          , Wwf         , Gs^Fdf      , Gs^Fdf      , Re          , Re          , Re^Gvs      , Chs         , Wwf         , Gs          , Re^Gvs      , Wwf         , Ww^Vm       , Gs^Fmf      , Gs^Fp       , Gg          , Wwf         , Re          , Ss          , Re          , Gs^Fdf      , Xv          , Xv          
Xv          , Xv          , Gg          , Gs^Fdf      , Re          , Re          , Re          , Re          , Gs          , Re          , Gs^Fdw      , Ww          , Chw         , Wwf         , Hh          , Hh          , Hh^Fmf      , Hh          , Re^Gvs      , Wwf         , Hh          , Wwf         , Wwf         , Wwf         , Ww          , Wwf         , Wwf         , Wwf         , Gs          , Re          , Re          , Re          , Gs^Fdf      , Xv          , Xv          
Xv          , Xv          , Gs^Fdf      , Hh^Fdf      , Mm          , Re          , Re          , Re          , Ss          , Ss          , Ss          , Ww          , Gs^Fdf      , Wwf         , Hh^Fdf      , Gs^Fdf      , Hh^Fdf      , Gs^Fdf      , Hh          , Wwf         , Wwf         , Gs^Fdf      , Ggf         , Ggf         , Chw         , Ww          , Gs^Fdw      , Rr          , Gs          , Gs          , Gs          , Hh^Fdf      , Chs         , Xv          , Xv          
Xv          , Xv          , Chs         , Hh^Fmf      , Gs          , Gs          , Gs          , Gs          , Gs^Fdw      , Ww          , Chw         , Ggf         , Ggf         , Wwf         , Wwf         , Gg          , Hh          , Mm          , Hh^Fdf      , Gg          , Hh^Fmf      , Wwf         , Gs^Fdf      , Ggf         , Ss          , Ww          , Ss          , Gs          , Re          , Gs          , Mm          , Hh^Fmf      , Gs^Fdf      , Xv          , Xv          
Xv          , Xv          , Gs^Fdf      , Hh^Fdf      , Re          , Gs          , Gs          , Rr          , Wwf         , Ww          , Ww          , Ggf         , Wwf         , Gs^Fdf      , Hh          , Wwf         , Re^Gvs      , Hh^Fmf      , Hh^Fdf      , Gs^Fmf      , Hh          , Wwf         , Chw         , Ww          , Gs^Fdw      , Ss          , Gs          , Re          , Re          , Re          , Re          , Hh^Fdf      , Gg          , Xv          , Xv          
Xv          , Xv          , Gs^Fdf      , Re          , Ss          , Re          , Wwf         , Wwf         , Gs^Fp       , Wwf         , Ww^Vm       , Wwf         , Re^Gvs      , Wwf         , Wwf         , Wwf         , Re^Gvs      , Hh          , Re          , Hh          , Gs^Fdf      , Wwf         , Ww          , Ww          , Gs          , Re          , Re          , Re          , Ss          , Re          , Re          , Gs^Fdf      , Hh^Fdf      , Xv          , Xv          
Xv          , Xv          , Ss          , Re          , Re          , Re          , Wwf         , Gg          , Gg          , Gs^Fmf      , Hh          , Wwf         , Gs          , Gs          , Ds          , Chs         , Re          , Re          , Re          , Gs^Fdf      , Wwf         , Wwf         , Re          , Gs          , Re          , Re          , Re          , Hh          , Re          , Re          , Re          , Re          , Gs^Fdf      , Xv          , Xv          
Xv          , Xv          , Ss          , Re          , Gs^Fp       , Re          , Re          , Wwf         , Gg          , Gg          , Gg          , Ss          , Re^Gvs      , Chr         , Ggf         , Ggf         , Gs^Vht      , Gg          , Wwf         , Wwf         , Wwf         , Re^Gvs      , Ds          , Ds          , Ds          , Ce          , Ke          , Re          , Re          , Gg^Vh       , Ss          , Ss          , Gs^Fdf      , Xv          , Xv          
Xv          , Xv          , Xv          , Ss          , Ss          , Mm          , Re          , Wwf         , Gg          , Mm          , Ss          , Ss          , Ss          , Gs          , Re^Gvs      , Gs          , Wwf         , Wwf         , Re          , Re^Gvs      , Gg^Vh       , Wwf         , Re          , Hd          , Gs^Fdf      , Gs^Fdf      , Ds^Dr       , Re          , Re          , Ss          , Gs^Fdf      , Hh^Fdf      , Xv          , Xv          , Xv          
Xv          , Xv          , Xv          , Xv          , Xv          , Re          , Gg          , Wwf         , Wwf         , Wwf         , Ds          , Re^Gvs      , Re          , Wwf         , Ss          , Wwf         , Re          , Re          , Re          , Re          , Gg          , Wwf         , Re^Gvs      , Gs^Fdf      , Gs^Fdf      , Re          , Re          , Re          , Ss          , Hh^Fdf      , Xv          , Xv          , Xv          , Xv          , Xv          
Xv          , Xv          , Xv          , Xv          , Xv          , Gs^Fdf      , Gg          , Gg          , Wwf         , Re          , Re          , Hh          , Gg          , Re          , Gs^Fdf      , Re          , Re^Gvs      , Re^Gvs      , Ww          , Re          , Ww          , Wwf         , Wwf         , Ds          , Re          , Re          , Re          , Re          , Ss          , Gs^Fdf      , Xv          , Xv          , Xv          , Xv          , Xv          
Xv          , Xv          , Xv          , Xv          , Xv          , Gs^Fdf      , Gg          , Gg          , Wwf         , Gg^Ve       , Gg          , Re          , Ggf         , Re          , Re          , Re          , Re^Gvs      , Ww          , Ww          , Ww          , Ggf         , Gg^Fet      , Wwf         , Re          , Gs          , Re          , Re          , Re          , Gs          , Gs^Fdf      , Xv          , Xv          , Xv          , Xv          , Xv          
Xv          , Xv          , Xv          , Xv          , Xv          , Gs^Fdw      , Gg          , Gg          , Gs^Fdf      , Wwf         , Wwf         , Gg          , Gg          , Gg          , Gs^Fdf      , Ggf         , Gg          , Chw         , Gg          , Gg          , Gg          , Ggf         , Wwf         , Re^Gvs      , Gg          , Re          , Ss          , Ss          , Hh          , Gs^Fdf      , Xv          , Xv          , Xv          , Xv          , Xv          
Xv          , Xv          , Xv          , Xv          , Xv          , Gs^Fdf      , Gs^Fdw      , Gg          , Gg          , Hh          , Wwf         , Gg          , Ggf         , Gg          , Gg          , Chr         , Chr         , 1 Khr       , Chr         , Chw         , Wwf         , Wwf         , Gg          , Re^Gvs      , Gg          , Gg          , Gg^Ve       , Gs^Fp       , Re^Gvs      , Gs          , Xv          , Xv          , Xv          , Xv          , Xv          
Xv          , Xv          , Xv          , Xv          , Xv          , Xv          , Xv          , Mm          , Hh          , Gg          , Wwf         , Gg          , Chw         , Gg          , Gg          , Gg          , Gg          , Chr         , Wwf         , Wwf         , Gg          , Ss          , Gg          , Gg          , Gg          , Gg          , Hh          , Re^Gvs      , Xv          , Xv          , Xv          , Xv          , Xv          , Xv          , Xv          
Xv          , Xv          , Xv          , Xv          , Xv          , Xv          , Xv          , Xv          , Gs^Fdf      , Gg          , Gg          , Wwf         , Wwf         , Gg          , Gg          , Gg          , Gg          , Chw         , Wwf         , Gg          , Gg          , Gg^Ve       , Gg          , Gg          , Gs^Fmf      , Gg          , Ds          , Xv          , Xv          , Xv          , Xv          , Xv          , Xv          , Xv          , Xv          
Xv          , Xv          , Xv          , Xv          , Xv          , Xv          , Xv          , Xv          , Gs^Fmf      , Gs^Fp       , Gs^Fdf      , Gg          , Gg          , Wwf         , Wwf         , Gg          , Wwf         , Wwf         , Re          , Gg          , Re          , Gs^Fmf      , Re          , Gs^Fmf      , Gg          , Gg          , Dd^Dc       , Xv          , Xv          , Xv          , Xv          , Xv          , Xv          , Xv          , Xv          
Xv          , Xv          , Xv          , Xv          , Xv          , Xv          , Xv          , Xv          , Xv          , Gs^Fmf      , Gs^Fp       , Gg^Ve       , Gg          , Gg          , Ds          , Wwf         , Ss          , Gs^Fdf      , Ss          , Re          , Re          , Re          , Re          , Dd          , Ds          , Ds          , Xv          , Xv          , Xv          , Xv          , Xv          , Xv          , Xv          , Xv          , Xv          
Xv          , Xv          , Xv          , Xv          , Xv          , Xv          , Xv          , Xv          , Xv          , Xv          , Xv          , Gs^Fdf      , Gs^Fp       , Gg          , Xv          , Gs^Fdw      , Gs^Fdf      , Gs^Fdw      , Gs^Fdw      , Gs^Fdf      , Xv          , Re          , Dd^Vda      , Ds          , Xv          , Xv          , Xv          , Xv          , Xv          , Xv          , Xv          , Xv          , Xv          , Xv          , Xv          
Xv          , Xv          , Xv          , Xv          , Xv          , Xv          , Xv          , Xv          , Xv          , Xv          , Xv          , Xv          , Xv          , Xv          , Xv          , Xv          , Xv          , Gs^Fdf      , Xv          , Xv          , Xv          , Xv          , Xv          , Xv          , Xv          , Xv          , Xv          , Xv          , Xv          , Xv          , Xv          , Xv          , Xv          , Xv          , Xv          
Xv          , Xv          , Xv          , Xv          , Xv          , Xv          , Xv          , Xv          , Xv          , Xv          , Xv          , Xv          , Xv          , Xv          , Xv          , Xv          , Xv          , Xv          , Xv          , Xv          , Xv          , Xv          , Xv          , Xv          , Xv          , Xv          , Xv          , Xv          , Xv          , Xv          , Xv          , Xv          , Xv          , Xv          , Xv          
