border_size=1
usage=map

Xv          , Xv          , Xv          , Xv          , Xv          , Xv          , Xv          , Xv          , Xv          , Xv          , Xv          , Xv          , Xv          , Xv          , Xv          , Xv          , Xv          , Xv          , Xv          , Xv          , Xv          , Xv          , Xv          , Xv          , Xv          , Xv          , Xv          , Xv          , Xv          , Xv          , Xv          , Xv          , Xv          , Xv          , Xv          
Xv          , Xv          , Xv          , Xv          , Xv          , Xv          , Xv          , Xv          , Xv          , Xv          , Xv          , Xv          , Xv          , Xv          , Xv          , Xv          , Xv          , Xv          , Xv          , Xv          , Xv          , Xv          , Xv          , Xv          , Xv          , Xv          , Xv          , Xv          , Xv          , Xv          , Xv          , Xv          , Xv          , Xv          , Xv          
Xv          , Xv          , Ww          , Ww          , Wo          , Wo          , Ww          , Ww          , Ww          , Ww          , Ww          , Wo          , Ww          , Ww          , Wwf         , Wwf         , Wwf^Bw/     , Rp          , Gg^Fds      , Gg^Fds      , Wwf         , Xv          , Xv          , Xv          , Xv          , Xv          , Xv          , Xv          , Xv          , Xv          , Xv          , Xv          , Xv          , Xv          , Xv          
Xv          , Xv          , Wo          , Wo          , Ww          , Ww          , Wwf         , Wwf         , Wwf         , Wwf         , Wwf         , Ww          , Ww          , Wwf         , Gg          , Rp          , Gg          , Wwf         , Wwf         , Hh^Fds      , Wwf         , Gg          , Hh^Fp       , Xv          , Xv          , Xv          , Xv          , Xv          , Xv          , Xv          , Xv          , Xv          , Xv          , Xv          , Xv          
Xv          , Xv          , Wo          , Ww          , Wwf         , Wwf         , Rp          , Chw         , Re          , Gs^Fds      , Gs^Fds      , Wwf         , Wwf         , Wwf         , Gg^Uf       , Gg^Fet      , Gg          , Wwf         , Wo          , Wwf         , Gg          , Ggf         , Hh^Fp       , Mm^Xm       , Mm^Xm       , Xv          , Xv          , Xv          , Xv          , Xv          , Xv          , Xv          , Xv          , Xv          , Xv          
Xv          , Xv          , Wo          , Ww          , Wwf         , Rp^Uf       , 1 Khr       , Chr         , Re          , Ggf         , Gg          , Gg          , Wwf         , Wwf         , Wwf         , Ggf         , Wwf         , Wwf         , Wwf         , Wwf         , Wwf         , Gs^Fp       , Mm^Xm       , Mm^Xm       , Hh^Uf       , Mm^Xm       , Wwf         , Xv          , Xv          , Xv          , Xv          , Xv          , Xv          , Xv          , Xv          
Xv          , Xv          , Wo          , Ww          , Wwf         , Rp          , Chw         , Rp          , Rp          , Re          , Wwf         , Wwf         , Gg          , Gs^Fds      , Hh          , Wwf         , Rp          , Gg^Uf       , Gg          , Gg          , Re^Gvs      , Wwf^Fp      , Hh^Vc       , Hh          , Ggf         , Hh          , Hh^Fp       , Wwf         , Ggf         , Xv          , Xv          , Xv          , Xv          , Xv          , Xv          
Xv          , Xv          , Wo          , Ww          , Ww          , Wwf^Bw/     , Gg          , Re          , Re          , Rp          , Wwf         , Re          , Re          , Gg^Ve       , Wwf         , Wwf         , Gg          , Gg          , Gg^Gvs      , Re^Gvs      , Ggf         , Re^Gvs      , Re          , Gg          , Gg          , Mm          , Gs^Fp       , Wo          , Wwf^Bw/     , Rd          , Mm^Xm       , Xv          , Xv          , Xv          , Xv          
Xv          , Xv          , Ww          , Wo          , Ww          , Wwf         , Wwf         , Gg          , Wwf^Fds     , Wo          , Wo          , Rp          , Rp          , Re          , Wwf         , Gg^Uf       , Gg          , Ggf         , Re^Gvs      , Re^Gvs      , Re^Gvs      , Re^Gvs      , Re          , Gs^Fp       , Hh^Vhh      , Gg          , Rd          , Rd          , Hh^Fp       , Wwf         , Gs^Fp       , Mm^Xm       , Mm^Xm       , Xv          , Xv          
Xv          , Xv          , Wo          , Wo          , Ww          , Ww          , Wwf         , Wo          , Gg          , Gg          , Wo          , Wwf^Uf      , Ww          , Rp          , Rp          , Wwf         , Wwf         , Gg          , Gg^Gvs      , Gg^Vc       , Re          , Re          , Hh^Uf       , Re          , Re          , Ggf         , Rd          , Mm          , Mm^Xm       , Wwf         , Gg          , Hh^Fp       , Mm^Xm       , Xv          , Xv          
Xv          , Xv          , Wo          , Ww          , Wwf         , Wwf         , Wwf         , Gg          , Wwf         , Gg^Uf       , Wwf         , Re          , Mm^Xm       , Mm^Xm       , Mm          , Rp          , Khr         , Wwf         , Chw         , Ggf         , Re          , Mm          , Gs^Fp       , Hh          , Rd          , Rd          , Gg          , Gg          , Wwf         , Wwf         , Wwf         , Hh^Fp       , Hh          , Xv          , Xv          
Xv          , Xv          , Ww          , Ww          , Hh^Fp       , Ggf         , Wwf         , Ss^Vhs      , Wwf         , Wo          , Gg          , Re          , Re          , Gs^Fp       , Rd          , Rd          , Chs         , Chw         , Khs         , Rp          , Rp          , Re          , Rd          , Rd          , Gg          , Gg          , Ggf         , Wwf         , Mm          , Mm^Xm       , Hh^Uf       , Wwf         , Rp          , Xv          , Xv          
Xv          , Xv          , Ww          , Wwf         , Mm^Xm       , Rp          , Gg^Uf       , Ww          , Wwf         , Wo          , Wo          , Ce          , Ce          , Re          , Rd          , Gg          , Hh^Uf       , Chs         , Ss          , Re          , Re          , Rp          , Rp          , Khw         , Chw         , Wwf         , Wwf         , Wwf         , Hh^Uf       , Mm^Xm       , Mm^Xm       , Wwf         , Wwf         , Xv          , Xv          
Xv          , Xv          , Wwf         , Wwf         , Wwf         , Wwf         , Wwf         , Wo          , Wwf         , Ww          , Gg          , Gg          , Re^Fet      , Ke          , Rd          , Gg          , Ss^Vm       , Ss          , Ww          , Re^Vct      , Gg          , Re          , Wwf         , Chw         , Gg          , Rp          , Wwf         , Rp          , Wwf         , Gs^Fp       , Rd          , Rd          , Mm^Xm       , Xv          , Xv          
Xv          , Xv          , Wwf         , Wo          , Wwf         , Ww          , Wwf         , Hh^Fms      , Wwf         , Wwf         , Re^Vct      , Re          , Rd          , Rd          , Gg          , Mm          , Wo          , Wo          , Wo          , Wwf^Fds     , Gg          , Gg          , Ggf         , Wwf         , Wwf         , Gg          , Ggf         , Wwf         , Rp          , Wwf         , Wwf         , Mm          , Hh^Uf       , Xv          , Xv          
Xv          , Xv          , Ss          , Wwf         , Gg          , Wwf         , Wo          , Wwf         , Wo          , Hh^Uf       , Gs^Fds      , Rd          , Gg^Uf       , Gg          , Rp          , Rp          , Wwf         , Wwr         , Wwf         , Wwf         , Wwf^Fds     , Hh          , Wo          , Wwf^Uf      , Gg          , Gg          , Rp          , Gg          , Gg          , Rp          , Wwf         , Gs^Fp       , Hh^Fp       , Xv          , Xv          
Xv          , Xv          , Gs^Fp       , Chs         , Ggf         , Ww          , Wwf         , Wwf         , Wwf         , Wwf         , Ww          , Rd          , Gs^Fds      , Hh          , Wo          , Wwf         , Wwf^Uf      , Wwf^Fds     , Hh          , Wo          , Wwf         , Wwf         , Ww          , Wwf         , Wwf         , Rp          , Ww          , Wwf         , Wwf         , Wwf         , Hh          , Wwf         , Wwf         , Xv          , Xv          
Xv          , Xv          , Wwf         , Gg          , Hh          , Gg          , Wwf         , Wo          , Ww          , Wwf         , Wwf         , Wwf         , Ww          , Wwf         , Wwf         , Wo          , Hh          , Ww          , Wwf^Uf      , Wo          , Wo          , Wwf         , Gs^Fds      , Wwf         , Ww          , Wwf         , Wwf         , Wo          , Wwf         , Gg          , Ggf         , Gg          , Gs^Fp       , Xv          , Xv          
Xv          , Xv          , Hh^Fp       , Wwf         , Wwf         , Wwf         , Gg          , Wwf         , Rp          , Rp          , Gg          , Wwf         , Wo          , Wwf         , Wwf^Fds     , Wo          , Wwf         , Wwf^Fds     , Wwf         , Wwf         , Rp          , Hh          , Gg^Uf       , Rd          , Gs^Fds      , Wwf         , Wo          , Wwf         , Wo          , Ww          , Gg          , Chs         , Ss          , Xv          , Xv          
Xv          , Xv          , Hh^Uf       , Gs^Fp       , Wwf         , Rp          , Rp          , Gg          , Ggf         , Gg          , Wwf         , Wwf^Uf      , Ggf         , Hh          , Gg          , Wwf         , Wo          , Wwr         , Wo          , Rp          , Gg          , Gg          , Rd          , Rd          , Re^Vct      , Hh^Uf       , Wwf         , Wwf         , Wwf         , Wwf         , Wwf         , Wwf         , Wwf         , Xv          , Xv          
Xv          , Xv          , Mm^Xm       , Mm          , Rd          , Wwf         , Wwf         , Wwf         , Wwf         , Gg          , Gg          , Wwf         , Wwf         , Gg          , Gg          , Wwf^Fds     , Ww          , Wo          , Ss^Vm       , Mm          , Rd          , Rd          , Re          , Re          , Gg          , Wwf         , Wo          , Hh^Fms      , Wwf         , Ww          , Wwf         , Wo          , Wwf         , Xv          , Xv          
Xv          , Xv          , Wwf         , Rd          , Mm^Xm       , Gs^Fp       , Hh^Uf       , Rp          , Wwf         , Rp          , Chw         , Chw         , Rp          , Re          , Re          , Re          , Ss          , Ss          , Hh^Uf       , Rd          , Gs^Fp       , Re          , Ke          , Ce          , Wo          , Wwf         , Wo          , Ww          , Gg^Uf       , Wwf         , Mm^Xm       , Wwf         , Ww          , Xv          , Xv          
Xv          , Xv          , Rp          , Wwf         , Hh^Uf       , Mm^Xm       , Mm          , Wwf         , Rp          , Wwf         , Wwf         , Khw         , Rd          , Rp          , Rp          , Re          , Khs         , Chs         , Chs         , Rd          , Mm^Xm       , Re          , Gg          , Ce          , Gg          , Wwf         , Wwf         , Wo          , Wwf         , Rp          , Hh^Fp       , Wwf         , Ww          , Xv          , Xv          
Xv          , Xv          , Hh          , Wwf         , Wwf         , Mm^Xm       , Wwf         , Wwf         , Gg          , Ggf         , Rd          , Rd          , Hh          , Gs^Fp       , Hh^Vc       , Rp          , Chw         , Chw         , Khr         , Rd          , Rd          , Re          , Re          , Ggf         , Wwf         , Ww          , Wwf^Uf      , Ss^Vhs      , Wwf         , Ggf         , Wwf         , Ww          , Wo          , Xv          , Xv          
Xv          , Xv          , Mm^Xm       , Hh^Fp       , Gg          , Wwf         , Mm^Xm       , Ggf         , Gg          , Gg          , Rd          , Rd^Uf       , Re          , Hh          , Re          , Re          , Re          , Wwf         , Wwf         , Rp          , Rp          , Rd          , Re          , Gg          , Wo          , Ggf         , Gg          , Gg          , Wwf         , Wwf         , Ww          , Ww          , Wo          , Xv          , Xv          
Xv          , Xv          , Mm^Xm       , Hh^Fp       , Gs^Fp       , Wwf         , Hh^Fp       , Mm          , Rd          , Rd          , Hh^Vhh      , Re          , Gs^Fp       , Re          , Gg^Gvs      , Gg^Gvs      , Re          , Gg^Gvs      , Gg^Gvs      , Wwf         , Wwf         , Rp          , Rp          , Re^Uf       , Wo          , Gg          , Wwf^Fds     , Wo          , Wwf         , Ww          , Ww          , Wo          , Ww          , Xv          , Xv          
Xv          , Xv          , Xv          , Mm^Xm       , Mm^Xm       , Wwf         , Wwf^Bw/     , Rd          , Gs^Fp       , Ggf         , Gg          , Hh          , Gg          , Gg^Gvs      , Re          , Re          , Re^Gvs      , Gg^Vc       , Ggf         , Gg^Uf       , Wwf         , Re          , Re          , Rp          , Wwf         , Wwf         , Re          , Gg          , Gg          , Wwf         , Ww          , Wo          , Wo          , Xv          , Xv          
Xv          , Xv          , Xv          , Xv          , Xv          , Rd          , Gg          , Wo          , Hh^Fp       , Mm          , Ggf         , Gg          , Hh^Fp       , Ggf         , Re^Vct      , Re^Gvs      , Gg          , Gg          , Gg          , Wwf         , Gg          , Ggf         , Gg          , Re          , Wwf         , Rp          , Rp          , Re          , Chw         , Wwf^Bw/     , Wwf         , Ww          , Wo          , Xv          , Xv          
Xv          , Xv          , Xv          , Xv          , Xv          , Xv          , Xv          , Wwf         , Wwf         , Hh          , Hh^Uf       , Hh          , Mm^Xm       , Hh^Fp       , Re          , Re          , Re          , Re^Uf       , Wwf         , Wwf         , Wwf         , Gg^Ve       , Gs^Fds      , Wwf         , Gg          , Re          , Re          , Rp          , 2 Khr       , Rp          , Wwf         , Ww          , Wo          , Xv          , Xv          
Xv          , Xv          , Xv          , Xv          , Xv          , Xv          , Xv          , Xv          , Xv          , Mm^Xm       , Mm^Xm       , Mm^Xm       , Hh^Uf       , Gs^Fp       , Re          , Mm          , Mm^Xm       , Wwf         , Ggf         , Gg          , Wwf         , Hh          , Wwf         , Wwf         , Gs^Fds      , Ggf         , Re          , Chr         , Rp          , Rp^Uf       , Wwf         , Ww          , Wo          , Xv          , Xv          
Xv          , Xv          , Xv          , Xv          , Xv          , Xv          , Xv          , Xv          , Xv          , Xv          , Xv          , Mm^Xm       , Hh          , Gs^Fp       , Rp          , Re^Uf       , Re          , Wwf         , Gg          , Gg^Fet      , Rp          , Wwf         , Ww          , Wwf         , Wwf         , Gs^Fds      , Wwf         , Chw         , Wwf         , Wwf         , Ww          , Ww          , Wo          , Xv          , Xv          
Xv          , Xv          , Xv          , Xv          , Xv          , Xv          , Xv          , Xv          , Xv          , Xv          , Xv          , Xv          , Xv          , Rp          , Gg^Fds      , Rp          , Rp          , Wwf         , Wwf^Bw/     , Rp          , Wwf         , Wwf         , Ww          , Ww          , Ww          , Wwf         , Ww          , Wwf         , Ww          , Ww          , Wo          , Wo          , Ww          , Xv          , Xv          
Xv          , Xv          , Xv          , Xv          , Xv          , Xv          , Xv          , Xv          , Xv          , Xv          , Xv          , Xv          , Xv          , Xv          , Xv          , Gg^Fds      , Xv          , Rp          , Xv          , Wwf         , Xv          , Ww          , Xv          , Wo          , Xv          , Ww          , Xv          , Ww          , Xv          , Wo          , Xv          , Ww          , Xv          , Xv          , Xv          
Xv          , Xv          , Xv          , Xv          , Xv          , Xv          , Xv          , Xv          , Xv          , Xv          , Xv          , Xv          , Xv          , Xv          , Xv          , Xv          , Xv          , Xv          , Xv          , Xv          , Xv          , Xv          , Xv          , Xv          , Xv          , Xv          , Xv          , Xv          , Xv          , Xv          , Xv          , Xv          , Xv          , Xv          , Xv          
Xv          , Xv          , Xv          , Xv          , Xv          , Xv          , Xv          , Xv          , Xv          , Xv          , Xv          , Xv          , Xv          , Xv          , Xv          , Xv          , Xv          , Xv          , Xv          , Xv          , Xv          , Xv          , Xv          , Xv          , Xv          , Xv          , Xv          , Xv          , Xv          , Xv          , Xv          , Xv          , Xv          , Xv          , Xv          
