border_size=1
usage=map

Xv          , Xv          , Xv          , Xv          , Xv          , Xv          , Xv          , Xv          , Xv          , Xv          , Xv          , Xv          , Xv          , Xv          , Xv          , Xv          , Xv          , Xv          , Xv          , Xv          , Xv          , Xv          , Xv          , Xv          , Xv          , Xv          , Xv          , Xv          , Xv          , Xv          , Xv          , Xv          , Xv          , Xv          , Xv          
Xv          , Xv          , Xv          , Xv          , Xv          , Xv          , Xv          , Xv          , Xv          , Xv          , Xv          , Xv          , Xv          , Xv          , Xv          , Xv          , Xv          , Xv          , Xv          , Xv          , Xv          , Xv          , Xv          , Xv          , Xv          , Xv          , Xv          , Xv          , Xv          , Xv          , Xv          , Xv          , Xv          , Xv          , Xv          
Xv          , Xv          , Wo          , Wo          , Wo          , Wo          , Ww          , Ww          , Ww          , Ww          , Ww          , Wo          , Ww          , Ww          , Wwf         , Wwf         , Wwf^Bw/     , Rp          , Gs^Fds      , Gs^Fds      , Wwf         , Xv          , Xv          , Xv          , Xv          , Xv          , Xv          , Xv          , Xv          , Xv          , Xv          , Xv          , Xv          , Xv          , Xv          
Xv          , Xv          , Wo          , Wo          , Ww          , Ww          , Wwf         , Wwf         , Wwf         , Wwf         , Wwf         , Ww          , Ww          , Wwf         , Gg          , Rp          , Gg          , Wwf         , Wwf         , Hh^Fds      , Wwf         , Gg          , Hh^Fp       , Xv          , Xv          , Xv          , Xv          , Xv          , Xv          , Xv          , Xv          , Xv          , Xv          , Xv          , Xv          
Xv          , Xv          , Wo          , Ww          , Wwf         , Wwf         , Rp          , Chw         , Re          , Gs^Fds      , Gs^Fds      , Wwf         , Wwf         , Wwf         , Gg^Uf       , Gg^Fet      , Gg          , Wwf         , Wo          , Wwf         , Gg          , Ggf         , Hh^Fp       , Mm^Xm       , Mm^Xm       , Xv          , Xv          , Xv          , Xv          , Xv          , Xv          , Xv          , Xv          , Xv          , Xv          
Xv          , Xv          , Wo          , Ww          , Wwf         , Rp^Uf       , 1 Khr       , Chr         , Re          , Ggf         , Gg          , Gg          , Wwf         , Wwf         , Wwf         , Ggf         , Wwf         , Wwf         , Wwf         , Wwf         , Wwf         , Gs^Fp       , Mm^Xm       , Mm^Xm       , Hh^Uf       , Mm^Xm       , Wwf         , Xv          , Xv          , Xv          , Xv          , Xv          , Xv          , Xv          , Xv          
Xv          , Xv          , Wo          , Ww          , Wwf         , Rp          , Chw         , Rp          , Rp          , Re          , Wwf         , Wwf         , Gg          , Gs^Fds      , Hh          , Wwf         , Wwf         , Gg^Uf       , Gg          , Gg^Gvs      , Re^Gvs      , Gs^Fp       , Hh^Vc       , Hh          , Gg          , Hh          , Hh^Fp       , Wwf         , Gg          , Xv          , Xv          , Xv          , Xv          , Xv          , Xv          
Xv          , Xv          , Wo          , Ww          , Ww          , Wwf^Bw/     , Gg          , Re          , Re          , Rp          , Wwf         , Re          , Re          , Gg^Vc       , Wwf         , Wwf         , Gg          , Gg          , Gg^Gvs      , Re^Gvs      , Ggf         , Re^Gvs      , Re          , Re          , Re          , Mm          , Gs^Fp       , Wo          , Wwf^Bw/     , Rd          , Mm^Xm       , Xv          , Xv          , Xv          , Xv          
Xv          , Xv          , Wo          , Wo          , Ww          , Wwf         , Wwf         , Gg          , Gs^Fds      , Wo          , Wo          , Rp          , Rp          , Re          , Wwf         , Gg^Uf       , Gg          , Ggf         , Re^Gvs      , Re^Gvs      , Re^Gvs      , Re          , Mm^Xm       , Mm^Xm       , Mm^Xm       , Re          , Rd          , Rd          , Hh^Fp       , Wwf         , Gs^Fp       , Mm^Xm       , Mm^Xm       , Xv          , Xv          
Xv          , Xv          , Wo          , Wo          , Ww          , Ww          , Wwf         , Wo          , Gg          , Gg          , Wo          , Wwf^Uf      , Ww          , Rp          , Rp          , Wwf         , Wwf         , Gg          , Gg^Gvs      , Gg^Vc       , Re^Gvs      , Re          , Re          , Mm^Vhh      , Hh          , Mm^Xm       , Rd          , Mm          , Mm^Xm       , Wwf         , Gg          , Hh^Fp       , Mm^Xm       , Xv          , Xv          
Xv          , Xv          , Wo          , Ww          , Wwf         , Wwf         , Wwf         , Gg          , Wwf         , Gg^Uf       , Wwf         , Re          , Mm^Xm       , Mm^Xm       , Mm          , Rp          , Khr         , Wwf         , Chw         , Re^Gvs      , Gg          , Mm          , Hh          , Re          , Rd          , Rd          , Gg          , Ggf         , Wwf         , Wwf         , Wwf         , Hh^Fp       , Hh          , Xv          , Xv          
Xv          , Xv          , Ww          , Ww          , Hh^Fp       , Ggf         , Wwf         , Ss^Vhs      , Wwf         , Wo          , Gg          , Re          , Re          , Gs^Fp       , Rd          , Rd          , Chs         , Chw         , Khs         , Rp          , Rp          , Gs^Fp       , Rd          , Rd          , Ggf         , Gg          , Hh^Fp       , Wwf         , Hh^Uf       , Mm^Xm       , Hh^Uf       , Wwf         , Gg          , Xv          , Xv          
Xv          , Xv          , Ww          , Wwf         , Mm^Xm       , Rp          , Gg^Uf       , Ww          , Wwf         , Wo          , Wo          , Ce          , Ce          , Re          , Rd          , Gg          , Hh^Uf       , Chs         , Ss          , Re          , Re          , Rp          , Rp          , Khw         , Chw         , Wwf         , Wwf         , Wwf         , Mm^Xm       , Mm^Xm       , Mm^Xm       , Wwf         , Wwf         , Xv          , Xv          
Xv          , Xv          , Ww          , Wwf         , Wwf         , Wwf         , Wwf         , Wo          , Wwf         , Ww          , Gg          , Gg          , Re^Fet      , Ke          , Rd          , Gg          , Ss^Vm       , Ss          , Ww          , Re^Vct      , Gg          , Re          , Wwf         , Chw         , Gg          , Gg          , Wwf         , Mm^Xm       , Hh          , Hh^Uf       , Hh          , Mm^Xm       , Rp          , Xv          , Xv          
Xv          , Xv          , Wo          , Ww          , Wwf         , Ww          , Wwf         , Hh^Fds      , Wwf         , Wwf         , Re^Vct      , Re          , Rd          , Rd          , Gg          , Mm          , Wo          , Wo          , Wo          , Gs^Fds      , Gg          , Gg          , Ggf         , Wwf         , Wwf         , Ggf         , Gg          , Wwf         , Wwf         , Wwf         , Wwf         , Mm          , Rp          , Xv          , Xv          
Xv          , Xv          , Ww          , Ww          , Wwf         , Wwf         , Wo          , Wwf         , Wo          , Hh^Uf       , Gs^Fds      , Rd          , Gg^Uf       , Gg          , Rp          , Rp          , Wwf         , Wwr         , Wwf         , Wwf         , Gs^Fds      , Hh          , Wo          , Wwf^Uf      , Gg          , Gg          , Gs^Fds      , Gg          , Wwf         , Gg          , Wwf         , Rp          , Hh^Fp       , Xv          , Xv          
Xv          , Xv          , Wwf         , Wwf         , Wwf         , Ww          , Wwf         , Wwf         , Wwf         , Wwf         , Ww          , Rd          , Gs^Fds      , Hh          , Wo          , Wwf         , Hh^Uf       , Gs^Fds      , Uh          , Wo          , Wwf         , Wwf         , Ww          , Wwf         , Wwf         , Hh          , Wwr         , Wwf         , Wwf         , Gg          , Ggf         , Gs^Fp       , Gg          , Xv          , Xv          
Xv          , Xv          , Gg          , Gg          , Ggf         , Wwf         , Wwf         , Wo          , Wwr         , Wwf         , Wwf         , Wwf         , Ww          , Wwf         , Wwf         , Wo          , Uh          , Mm^Xm       , Hh^Uf       , Wo          , Wo          , Wwf         , Gs^Fds      , Wwf         , Ww          , Wwf         , Wwf         , Wo          , Wwf         , Wwf         , Wwf         , Gg          , Wwf         , Xv          , Xv          
Xv          , Xv          , Hh^Fp       , Gs^Fp       , Wwf         , Gg          , Wwf         , Wwf         , Gs^Fds      , Hh          , Gg          , Wwf         , Wo          , Wwf         , Gs^Fds      , Wo          , Wwf         , Gs^Fds      , Wwf         , Wwf         , Rp          , Hh          , Gg^Uf       , Rd          , Gs^Fds      , Wwf         , Wo          , Wwf         , Wo          , Ww          , Wwf         , Wwf         , Ww          , Xv          , Xv          
Xv          , Xv          , Rp          , Rp          , Wwf         , Gg          , Wwf         , Gg          , Gg          , Gg          , Wwf         , Wwf^Uf      , Ggf         , Hh          , Gg          , Wwf         , Wo          , Wwr         , Wo          , Rp          , Gg          , Gg          , Rd          , Rd          , Re^Vct      , Hh^Uf       , Wwf         , Wwf         , Wwf         , Wwf         , Wwf         , Ww          , Wo          , Xv          , Xv          
Xv          , Xv          , Rp          , Mm          , Hh          , Wwf         , Hh          , Wwf         , Wwf         , Ggf         , Gg          , Wwf         , Wwf         , Gg          , Gg          , Gs^Fds      , Ww          , Wo          , Ss^Vm       , Mm          , Rd          , Rd          , Re          , Re          , Gg          , Wwf         , Wo          , Hh^Fet      , Wwf         , Ww          , Wwf         , Ww          , Ww          , Xv          , Xv          
Xv          , Xv          , Wwf         , Mm^Xm       , Mm^Xm       , Hh^Uf       , Mm^Xm       , Mm^Xm       , Wwf         , Gg          , Chw         , Chw         , Rp          , Re          , Re          , Re          , Ss          , Ss          , Hh^Uf       , Rd          , Gs^Fp       , Re          , Ke          , Ce          , Wo          , Wwf         , Wo          , Ww          , Gg^Uf       , Wwf         , Mm^Xm       , Wwf         , Ww          , Xv          , Xv          
Xv          , Xv          , Gg          , Wwf         , Hh^Uf       , Mm^Xm       , Hh^Uf       , Wwf         , Hh^Fp       , Wwf         , Ggf         , Khw         , Rd          , Rp          , Rp          , Re          , Khs         , Chs         , Chs         , Rd          , Mm^Xm       , Re          , Gg          , Ce          , Gg          , Wwf         , Wwf         , Wo          , Wwf         , Rp          , Hh^Fp       , Wwf         , Ww          , Xv          , Xv          
Xv          , Xv          , Hh          , Wwf         , Wwf         , Mm^Xm       , Wwf         , Wwf         , Gg          , Gg          , Rd          , Rd          , Mm          , Gs^Fp       , Hh^Vc       , Rp          , Chw         , Chw         , Khr         , Rd          , Re          , Re          , Hh^Fds      , Ggf         , Wwf         , Ww          , Wwf^Uf      , Ss^Vhs      , Wwf         , Ggf         , Wwf         , Ww          , Wo          , Xv          , Xv          
Xv          , Xv          , Mm^Xm       , Hh^Fp       , Gg          , Wwf         , Mm^Xm       , Ggf         , Rd          , Rd          , Hh          , Re          , Re          , Hh          , Gg^Gvs      , Re^Gvs      , Re^Gvs      , Wwf         , Wwf         , Rp          , Rp          , Re          , Re          , Gg          , Wo          , Ggf         , Gg          , Gg          , Wwf         , Wwf         , Ww          , Ww          , Wo          , Xv          , Xv          
Xv          , Xv          , Mm^Xm       , Hh^Fp       , Gs^Fp       , Wwf         , Hh^Fp       , Mm          , Rd          , Mm^Xm       , Mm^Xm       , Mm^Vhh      , Mm^Xm       , Re          , Gg^Gvs      , Ggf         , Re^Gvs      , Gg^Gvs      , Gg          , Wwf         , Wwf         , Rp          , Rp          , Re^Uf       , Wo          , Gg          , Gs^Fds      , Wo          , Wwf         , Ww          , Ww          , Wo          , Wo          , Xv          , Xv          
Xv          , Xv          , Xv          , Mm^Xm       , Mm^Xm       , Wwf         , Wwf^Bw/     , Rd          , Gs^Fp       , Re          , Re          , Mm^Xm       , Re          , Re          , Re^Gvs      , Re^Gvs      , Gg^Gvs      , Gg^Vh       , Ggf         , Gg^Uf       , Wwf         , Re          , Re          , Rp          , Wwf         , Wwf         , Re          , Gg          , Gg          , Wwf         , Ww          , Wo          , Wo          , Xv          , Xv          
Xv          , Xv          , Xv          , Xv          , Xv          , Rd          , Gg          , Wo          , Hh^Fp       , Mm          , Gg          , Re          , Hh^Fp       , Hh^Vc       , Re^Gvs      , Gg^Gvs      , Gg          , Gg          , Gg          , Wwf         , Gg          , Ggf         , Gg          , Re          , Wwf         , Rp          , Rp          , Re          , Chw         , Wwf^Bw/     , Wwf         , Ww          , Wo          , Xv          , Xv          
Xv          , Xv          , Xv          , Xv          , Xv          , Xv          , Xv          , Wwf         , Wwf         , Hh          , Hh^Uf       , Hh          , Mm^Xm       , Gs^Fp       , Re          , Re          , Re          , Re^Uf       , Wwf         , Wwf         , Wwf         , Gg^Vc       , Gs^Fds      , Wwf         , Gg          , Re          , Re          , Rp          , 2 Khr       , Rp          , Wwf         , Ww          , Wo          , Xv          , Xv          
Xv          , Xv          , Xv          , Xv          , Xv          , Xv          , Xv          , Xv          , Xv          , Mm^Xm       , Mm^Xm       , Mm^Xm       , Hh^Fp       , Gs^Fp       , Re          , Mm          , Mm^Xm       , Wwf         , Ggf         , Gg          , Wwf         , Hh          , Wwf         , Wwf         , Gs^Fds      , Ggf         , Re          , Chr         , Rp          , Rp^Uf       , Wwf         , Ww          , Wo          , Xv          , Xv          
Xv          , Xv          , Xv          , Xv          , Xv          , Xv          , Xv          , Xv          , Xv          , Xv          , Xv          , Mm^Xm       , Hh^Fp       , Hh          , Rp          , Re^Uf       , Re          , Wwf         , Gg          , Gg^Fet      , Rp          , Wwf         , Ww          , Wwf         , Wwf         , Gs^Fds      , Wwf         , Chw         , Wwf         , Wwf         , Ww          , Ww          , Wo          , Xv          , Xv          
Xv          , Xv          , Xv          , Xv          , Xv          , Xv          , Xv          , Xv          , Xv          , Xv          , Xv          , Xv          , Xv          , Rp          , Gs^Fds      , Rp          , Rp          , Wwf         , Wwf^Bw/     , Rp          , Wwf         , Wwf         , Ww          , Ww          , Ww          , Wwf         , Ww          , Wwf         , Ww          , Ww          , Wo          , Wo          , Wo          , Xv          , Xv          
Xv          , Xv          , Xv          , Xv          , Xv          , Xv          , Xv          , Xv          , Xv          , Xv          , Xv          , Xv          , Xv          , Xv          , Xv          , Gs^Fds      , Xv          , Rp          , Xv          , Wwf         , Xv          , Ww          , Xv          , Wo          , Xv          , Ww          , Xv          , Ww          , Xv          , Wo          , Xv          , Wo          , Xv          , Xv          , Xv          
Xv          , Xv          , Xv          , Xv          , Xv          , Xv          , Xv          , Xv          , Xv          , Xv          , Xv          , Xv          , Xv          , Xv          , Xv          , Xv          , Xv          , Xv          , Xv          , Xv          , Xv          , Xv          , Xv          , Xv          , Xv          , Xv          , Xv          , Xv          , Xv          , Xv          , Xv          , Xv          , Xv          , Xv          , Xv          
Xv          , Xv          , Xv          , Xv          , Xv          , Xv          , Xv          , Xv          , Xv          , Xv          , Xv          , Xv          , Xv          , Xv          , Xv          , Xv          , Xv          , Xv          , Xv          , Xv          , Xv          , Xv          , Xv          , Xv          , Xv          , Xv          , Xv          , Xv          , Xv          , Xv          , Xv          , Xv          , Xv          , Xv          , Xv          
