border_size=1
usage=map

Mm          , Gg          , Hh          , Gg          , Gg^Uf       , Rr          , Gg          , Rr          , Rr          , Gg          , Gg^Fet      , Gg          , Gg          , Gg          , Gg          , Gg^Uf       , Gs^Fp       , Hh          , Hh          , Gg^Fet      , Gg          , Gg^Uf       , Rr          , Rr          , Gg          , Rr          , Gg^Fet      , Gg^Fet      , Hh          , Hh          , Mm          , Mm          , Ww          , Wo          , Wo          , Wo          , Wo          , Ww          , Hh          , Hh          , Mm          , Mm          , Mm          , Gs^Fp       , Hh          , Hh          , Gg^Fet      , Gg          
Mm          , Hh          , Mm          , Hh          , Rr          , Rr          , Gs^Fp       , Ggf         , Gg^Uf       , Rr          , Rr          , Rr          , Rr          , Gg          , Gg          , Ggf         , Gs^Fds      , Mm          , Gs^Fp       , Gg          , Rr          , Rr          , Gg^Uf       , Gg          , Gs^Fds      , Gg          , Gg          , Gs^Fp       , Gs^Fp       , Mm          , Hh          , Wwf         , Ww          , Wo          , Ww          , Wo          , Ww          , Ww          , Gs^Fp       , Hh          , Gs^Fp       , Hh          , Gs^Fp       , Gg^Uf       , Ggf         , Gs^Fp       , Gg          , Gg^Uf       
Gg          , Gs^Fp       , Gg^Fet      , Gg^Uf       , Rr          , Ggf         , Hh          , Mm          , Gs^Fp       , Gg          , Gg          , Gg          , Rr          , Gg^Uf       , Gg          , Gg          , Gg          , Hh          , Gg          , Gg          , Rr          , Gg          , Hh          , Mm          , Hh          , Gg          , Gg          , Gg^Uf       , Gg          , Gg          , Wwf         , Wwf         , Gg          , Ww          , Gg          , Ww          , Hh          , Mm          , Hh          , Gg^Uf       , Ggf         , Mm          , Gs^Fds      , Hh          , Rr          , Gg          , Rr          , Rr          
Ggf         , Gs^Fds      , Gg^Vc       , Rr          , Gg          , Gg          , Gg          , Hh          , Gg          , Gg          , Gg          , Gg^Vc       , Gg          , Rr          , Rr          , Rr          , Rr          , Gg          , Rr          , Rr          , Gg          , Gg          , Gg          , Gs^Fp       , Ggf         , Gg          , Gg          , Gg          , Gg          , Gg^Vc       , Wwf         , Gg          , Gg          , Hh          , Mm          , Gg          , Gg          , Gg^Fet      , Gg          , Gs^Fp       , Gg          , Gg          , Rr          , Rr          , Gg          , Rr          , Gg^Fet      , Gg          
Ggf         , Ggf         , Gg          , Rr          , Rr          , Gg          , Gg          , Gg          , Gg          , Gg          , Hh          , Gg          , Ggf         , Gg          , Gg          , Gg          , Gg          , Rr          , Gg          , Gg          , Gg          , Gg          , Gg          , Gg          , Gg          , Gg          , Gg          , Gg          , Wwf         , Wwf         , Gg          , Gg          , Gg          , Gg          , Ggf         , Gg          , Gg          , Gg          , Rr          , Gg          , Rr          , Rp^Vhc      , Gg          , Gg          , Gg          , Gg          , Wwf         , Wwf         
Gg          , Gs^Fp       , Hh          , Gg          , Rr          , Gg          , Kud         , Gg          , Gg          , Gg          , Gs^Fp       , Mm          , Gs^Fp       , Gg^Uf       , Gg          , Gg          , Gg          , Gg          , Cud         , Gg          , Xos         , Gg          , Gg          , Gg          , Gg          , Gs^Fp       , Gg          , Gg          , Wwf         , Wwf         , Gg          , Gg          , Gg          , Gg          , Gg          , Gs^Fds      , Rr          , Rr          , Gg          , Rr          , Gg          , Gg          , Mm          , Hh          , Gg          , Wwf         , Gg^Uf       , Gg          
Gg^Fet      , Hh          , Mm          , Gs^Fp       , Rr          , Cud         , Cud         , Gg          , Gg          , Gg          , Gg          , Gs^Fds      , Gg          , Gg          , Gg          , Gg          , Kud         , Cud         , Xos         , Cud         , Cud         , Xos         , Xos         , Gg          , Cud         , Gg          , Cud         , Wwf         , Cud         , Wwf         , Cud         , Gg          , Kud         , Gg          , Cud         , Rr          , Kud         , Gg          , Gg          , Gg          , Gg          , Hh          , Ggf         , Gs^Fp       , Wwf         , Wwf         , Gg          , Gg          
Gg          , Gg^Fet      , Gg^Uf       , Gg          , Rr          , Cud         , Gg          , Cud         , Cud         , Gg          , Gg          , Gg          , Gg          , Gg          , Cud         , Cud         , Xos         , Xos         , Ur          , Ur          , Xos         , Kud         , Xos         , Cud         , Xos         , Kud         , Xos         , Cud         , Wwf         , Cud         , Uu^Vud      , Cud         , Xos         , Cud         , Xos         , Cud         , Xos         , Cud         , Cud         , Gg          , Gg          , Gg          , Gg          , Gg          , Wwf         , Gg          , Gg          , Gg          
Rr          , Rr          , Rr          , Rr          , Gg          , Gg          , Gg          , Gg          , Gg          , Cud         , Cud         , Gg          , Cud         , Cud         , Rr          , Xos         , Ur^Uf       , Ur          , Ur          , Ur          , Ur^Dr       , Xos         , Ur          , Xos         , Ur          , Xos         , Wwf         , Gs^Fp       , Wwf         , Rr          , Ur          , Xos         , Ur          , Xos         , Ur^Dr       , Xos         , Ur^Uf       , Ur          , Cud         , Cud         , Cud         , Gg          , Wwf         , Wwf         , Gg          , Gg          , Gs^Fds      , Gg          
Gg^Uf       , Gg          , Gg          , Rr          , Rr          , Gg^Uf       , Gs^Fds      , Gg          , Gg          , Gg          , Gg          , Kud         , Xos         , Rr          , Ur          , Uu^Vud      , Ur          , Ur          , Xos         , Ur          , Ur          , Ur          , Ur          , Ur          , Ur          , Ur          , Ur          , Wwf         , Rr          , Rr          , Ur          , Ur          , Ur          , Ur          , Ur          , Uu^Vud      , Ur          , Ur          , Cud         , Cud         , Kud         , Wwf         , Cud         , Gg          , Gg          , Gs^Fp       , Mm          , Mm          
Gg          , Gg          , Mm          , Gg          , Rr          , Gg          , Gg          , Gg          , Gg          , Gg          , Gg          , Cud         , Xos         , Xos         , Ur          , Ur          , Ur          , Xos         , Ur          , Ur          , Ur          , Ur          , Ur          , Xos         , Ur          , Ur          , Xos         , Wwf         , Rr          , Ur          , Xos         , Ur^Dr       , Xos         , Ur          , Ur          , Ur          , Xos         , Ur          , Wwf         , Wwf         , Cud         , Cud         , Cud         , Gg          , Gg          , Mm          , Hh          , Hh          
Gg          , Gs^Fp       , Hh          , Hh          , Gg          , Rr          , Ggf         , Gs^Fp       , Hh          , Gg          , Gg          , Cud         , Xos         , Ur^Dr       , Ur          , Ur          , Xos         , Ur          , Ur          , Xos         , Ur          , Xos         , Ur          , Ur          , Xos         , Xos         , Ur          , Wwf         , Rr          , Ur          , Ur          , Xos         , Ur^Dr       , Xos         , Ur          , Xos         , Wwf         , Wwf         , Cud         , Cud         , Mm          , Hh^Uf       , Gs^Fds      , Gs^Fp       , Gg          , Gg          , Ggf         , Gs^Fp       
Ggf         , Gg^Fet      , Gg          , Gs^Fp       , Gg          , Rr          , Gg^Uf       , Hh          , Mm          , Gg          , Gg          , Cud         , Ur          , Ur          , Xos         , Ur          , Xos         , Xos         , Ur          , Xos         , Ur          , Xos         , Xos         , Uh          , Ur^Dr       , Xos         , Ur          , Wwf         , Wwf         , Rr          , Rr          , Ur          , Ur          , Xos         , Wwf         , Wwf         , Ur          , Wwf         , Wwf         , Cud         , Cud         , Hh          , Cud         , Hh          , Gg          , Gg          , Gg          , Gg^Fet      
Gg          , Ggf         , Gg          , Gg          , Gg          , Rr          , Rr          , Gs^Fp       , Gg          , Gg          , Gg          , Cud         , Ur          , Ur          , Xos         , Ur          , Ur          , Ur          , Xos         , Ur          , Ur          , Xos         , Ur^Dr       , Xos         , Xos         , Cud         , Ur          , Xos         , Wwf         , Xos         , Rr          , Xos         , Wwf         , Wwf         , Xos         , Gs^Fp       , Ur          , Xos         , Xos         , Wwf         , Wwf         , Kud         , Cud         , Gg          , Gg          , Gg          , Wwf         , Gg          
Gg          , Gg          , Gg^Uf       , Mm          , Hh          , Gg          , Rr          , Gg          , Gg          , Gg          , Cud         , Kud         , Xos         , Xos         , Ur          , Ur          , Xos         , Xos         , Ur          , Ur          , Xos         , Ur          , Ur          , Xos         , Cud         , Kud         , Xos         , Xos         , Wwf         , Xos         , Wwf         , Xos         , Wwf         , Gs^Fp       , Ur          , Ur          , Xos         , Ur          , Ur          , Xos         , Rr          , Cud         , Wwf         , Wwf         , Wwf         , Wwf         , Gg          , Wwf         
Gg          , Gg          , Gg          , Gs^Fp       , Rr          , Rr          , Gg          , Gg          , Cud         , Cud         , Xos         , Xos         , Ur          , Ur          , Xos         , Uh          , Ur          , Ur          , Xos         , Ur          , Ur          , Xos         , Xos         , Cud         , Rr          , Wo          , Xos         , Xos         , Wwf         , Wwf         , Ur^Dr       , Wwf         , Xos         , Ur          , Xos         , Ur^Dr       , Xos         , Ur          , Ur          , Xos         , Rr          , Cud         , Gg          , Gg          , Gg          , Gg          , Gg^Uf       , Gg          
Gg          , Gg          , Gs^Fds      , Gg          , Rr          , Gg          , Gg          , Gg          , Cud         , Rr          , Ur          , Ur          , Xos         , Ur          , Ur          , Ur          , Xos         , Xos         , Ur^Uf       , Xos         , Xos         , Ur          , Rr          , Rr          , Gg^Fet      , Wwf         , Wwf         , Wwf         , Xos         , Xos         , Ur          , Ur          , Xos         , Ur          , Ur          , Xos         , Ur          , Ur          , Ur          , Ur          , Rr          , Kud         , Ggf         , Mm          , Hh          , Gg          , Gs^Fp       , Gg^Fet      
Gg          , Gg          , Rr          , Rr          , Gs^Fp       , Gg          , Gg          , Kud         , Xos         , Ur          , Xos         , Xos         , Ur          , Uu^Vud      , Ur          , Xos         , Ur          , Xos         , Xos         , Ur          , Rr          , Xos         , Gg          , Mm          , Hh          , Gg^Uf       , Wwf         , Wwf         , Xos         , Rr          , Xos         , Xos         , Xos         , Xos         , Ur^Uf       , Ur          , Xos         , Ur          , Xos         , Xos         , Rr          , Cud         , Gg          , Gs^Fp       , Gg          , Gg          , Mm          , Gs^Fp       
Mm          , Hh          , Rr          , Gs^Fp       , Mm          , Hh          , Gg          , Cud         , Xos         , Ur          , Ur          , Ur          , Xos         , Ur          , Ur          , Ur          , Ur^Dr       , Ur          , Rr          , Xos         , Gg          , Gg          , Gg          , Gg          , Gg          , Wwf         , Wwf         , Gs^Fds      , Gg          , Gg          , Gg          , Rr          , Xos         , Uu^Vud      , Ur          , Ur          , Xos         , Ur          , Ur          , Rr          , Rr          , Cud         , Gg          , Gg          , Gg          , Hh          , Hh          , Hh          
Gg^Fet      , Mm          , Rr          , Gg^Uf       , Ggf         , Gg          , Gg          , Cud         , Rr          , Xos         , Ur          , Xos         , Ur          , Ur          , Ur          , Xos         , Xos         , Xos         , Hh          , Gg          , Gg          , Gg^Vc       , Gg          , Gg          , Gg          , Wwf         , Gg          , Gg          , Gg          , Gg^Vc       , Gg          , Gs^Fp       , Rr          , Ur          , Ur          , Ur          , Xos         , Xos         , Xos         , Rr          , Rr          , Cud         , Gg          , Gg          , Gg          , Gg          , Gg          , Gs^Fp       
Rr          , Rr          , Gg          , Gg          , Gg          , Gg^Vc       , Gg          , Cud         , Rr          , Ur          , Xos         , Ur          , Xos         , Ur          , Ur          , Ur          , Rr          , Gs^Fp       , Gg          , Gg          , Gg          , Gg          , Hh          , Gs^Fp       , Wwf         , Wwf         , Mm          , Hh          , Gg          , Gg          , Gg          , Hh          , Cud         , Cud         , Kud         , Cud         , Cud         , Cud         , Kud         , Cud         , Cud         , Cud         , Kud         , Cud         , Cud         , Cud         , 1 Kud       , Gg          
Gg^Fet      , Gg          , 2 Kud       , Gg          , Cud         , Gg          , Kud         , Cud         , Cud         , Cud         , Kud         , Cud         , Cud         , Cud         , Kud         , Cud         , Cud         , Gg          , Gg          , Gg          , Gg          , Gs^Fp       , Mm          , Hh          , Wwf         , Hh          , Hh          , Gs^Fp       , Gg          , Gg          , Gg          , Gg          , Rr          , Cud         , Ur          , Cud         , Xos         , Cud         , Xos         , Cud         , Rr          , Cud         , Gg          , Gg          , Gg          , Gg          , Gg          , Gg          
Gg^Uf       , Gg          , Gg          , Cud         , Gg          , Cud         , Gg          , Cud         , Rr          , Cud         , Xos         , Cud         , Xos         , Cud         , Ur          , Cud         , Rr          , Hh          , Gg          , Gg          , Gg          , Hh          , Gg          , Wwf         , Gg          , Gs^Fp       , Gg          , Gg          , Gg          , Gg          , Hh          , Gs^Fp       , Xos         , Ur          , Ur          , Ur          , Ur          , Ur          , Ur          , Ur          , Rr          , Cud         , Gg          , Gg^Vc       , Gg          , Gg          , Rr          , Rr          
Gg          , Gg          , Gg          , Gg          , Gg          , Gg          , Gg          , Cud         , Rr          , Rr          , Ur          , Xos         , Xos         , Ur          , Ur          , Ur          , Xos         , Gs^Fp       , Gg          , Gg^Vc       , Gg          , Gg          , Wwf         , Wwf         , Gg          , Gg          , Gg          , Gg^Vc       , Gg          , Gg          , Rr          , Xos         , Ur^Dr       , Xos         , Ur          , Ur          , Xos         , Xos         , Ur          , Xos         , Xos         , Cud         , Gg          , Gg          , Mm          , Ggf         , Rr          , Gg^Uf       
Ggf         , Gg          , Gs^Fp       , Gg          , Gg          , Gg          , Gg          , Cud         , Rr          , Rr          , Xos         , Ur          , Xos         , Ur          , Ur^Uf       , Uu^Vud      , Xos         , Rr          , Xos         , Gg          , Xos         , Gs^Fds      , Wwf         , Wwf         , Hh          , Gg          , Gg          , Gg          , Rr          , Xos         , Xos         , Ur          , Ur          , Ur          , Ur          , Ur          , Ur          , Ur          , Xos         , Ur          , Xos         , Cud         , Gg          , Hh          , Gs^Fp       , Gs^Fp       , Rr          , Gg          
Mm          , Mm          , Hh          , Gg          , Gs^Fp       , Hh          , Gg          , Cud         , Rr          , Xos         , Ur          , Ur          , Ur          , Ur          , Ur          , Xos         , Xos         , Xos         , Ur          , Rr          , Xos         , Wwf         , Wwf         , Gg^Uf       , Gg^Fet      , Mm          , Rr          , Xos         , Xos         , Ur          , Ur^Uf       , Xos         , Xos         , Xos         , Ur          , Uu^Vud      , Xos         , Xos         , Ur          , Ur          , Cud         , Kud         , Gg          , Gg          , Gg          , Rr          , Gg^Fet      , Gg          
Gg^Fet      , Hh          , Gs^Fp       , Gg          , Gg          , Mm          , Gg          , Kud         , Rr          , Ur          , Ur          , Ur          , Xos         , Xos         , Xos         , Ur          , Xos         , Ur          , Ur^Dr       , Xos         , Wwf         , Wwf         , Xos         , Wwf         , Rr          , Rr          , Xos         , Ur          , Ur          , Xos         , Xos         , Xos         , Ur          , Ur          , Xos         , Ur          , Ur          , Ur          , Xos         , Ur          , Cud         , Gg          , Gg          , Gg          , Gg          , Rr          , Ggf         , Gg          
Gg          , Gg^Uf       , Gg          , Gg          , Gg          , Gg          , Wwf         , Cud         , Rr          , Xos         , Ur          , Ur          , Xos         , Ur^Dr       , Ur          , Ur          , Wwf         , Wwf         , Wwf         , Wwf         , Wwf         , Xos         , Xos         , Wo          , Cud         , Cud         , Ur          , Xos         , Xos         , Ur          , Ur          , Ur          , Xos         , Uh          , Ur          , Ur          , Xos         , Xos         , Cud         , Cud         , Gg          , Gg          , Rr          , Rr          , Rr          , Rr          , Gg          , Gg          
Wwf         , Gg          , Wwf         , Wwf         , Wwf         , Wwf         , Cud         , Cud         , Wwf         , Xos         , Xos         , Ur          , Ur          , Ur          , Xos         , Gs^Fp       , Wwf         , Xos         , Rr          , Xos         , Wwf         , Xos         , Ur          , Kud         , Xos         , Xos         , Ur^Dr       , Ur          , Ur          , Ur          , Xos         , Xos         , Ur          , Ur          , Xos         , Xos         , Ur          , Kud         , Gg          , Gg          , Gg          , Rr          , Mm          , Hh          , Gs^Fp       , Gg          , Gs^Fds      , Gg          
Ggf         , Wwf         , Gg^Fet      , Gg          , Gg          , Gg          , Cud         , Kud         , Cud         , Wwf         , Wwf         , Xos         , Ur          , Gs^Fp       , Wwf         , Wwf         , Ur          , Xos         , Rr          , Xos         , Wwf         , Xos         , Ur          , Cud         , Ur^Dr       , Xos         , Xos         , Xos         , Ur          , Ur          , Ur          , Ur          , Xos         , Ur          , Xos         , Ur          , Ur          , Cud         , Gg          , Gg          , Gg^Uf       , Rr          , Gs^Fp       , Hh          , Gg          , Gg          , Gg          , Gg          
Gg          , Gg          , Mm          , Gs^Fp       , Ggf         , Hh          , Gs^Fds      , Hh          , Mm          , Cud         , Cud         , Wwf         , Wwf         , Wwf         , Ur          , Xos         , Ur^Dr       , Ur          , Ur          , Rr          , Rr          , Wwf         , Ur          , Xos         , Xos         , Uh          , Ur          , Xos         , Ur          , Xos         , Ur          , Xos         , Xos         , Ur          , Ur          , Ur          , Xos         , Cud         , Gg          , Gg          , Gg          , Rr          , Rr          , Gg          , Gg          , Gg          , Ggf         , Gs^Fp       
Ggf         , Gg          , Gg          , Hh          , Gg          , Gs^Fp       , Cud         , Hh^Uf       , Cud         , Cud         , Wwf         , Wwf         , Xos         , Xos         , Ur          , Xos         , Xos         , Xos         , Xos         , Ur          , Rr          , Wwf         , Xos         , Xos         , Ur          , Ur          , Ur          , Xos         , Ur          , Xos         , Ur          , Ur          , Ur          , Ur          , Ur          , Ur^Dr       , Xos         , Cud         , Gg          , Gg          , Ggf         , Gg          , Hh          , Rr          , Gg          , Gs^Fp       , Mm          , Gs^Fp       
Hh          , Hh          , Gs^Fp       , Gg          , Gg          , Gg          , Cud         , Cud         , Kud         , Wwf         , Cud         , Ur          , Ur          , Ur          , Ur          , Ur          , Ur          , Ur^Dr       , Ur          , Ur          , Rr          , Wwf         , Ur          , Ur          , Ur          , Xos         , Ur          , Ur          , Ur          , Ur          , Xos         , Xos         , Ur          , Ur          , Ur          , Xos         , Xos         , Cud         , Gg          , Gg          , Gg^Uf       , Mm          , Gs^Fp       , Rr          , Gg          , Hh          , Hh          , Hh          
Gs^Fp       , Mm          , Gg          , Gg          , Gg          , Gg          , Wwf         , Wwf         , Cud         , Cud         , Cud         , Ur          , Ur^Uf       , Uu^Vud      , Ur^Dr       , Ur          , Ur          , Ur          , Ur          , Rr          , Wwf         , Wwf         , Wwf         , Ur          , Ur          , Ur          , Ur          , Ur          , Ur^Dr       , Ur          , Ur          , Ur          , Ur^Uf       , Uu^Vud      , Rr          , Rr          , Cud         , Kud         , Cud         , Gg          , Gg          , Gs^Fds      , Gg          , Rr          , Rr          , Gs^Fp       , Gg^Uf       , Gg          
Gg          , Gs^Fp       , Gg          , Gg          , Wwf         , Wwf         , Gg          , Gg          , Gg          , Cud         , Cud         , Ur          , Xos         , Xos         , Xos         , Xos         , Xos         , Xos         , Uu^Vud      , Rr          , Wwf         , Gs^Fp       , Xos         , Xos         , Xos         , Xos         , Xos         , Xos         , Xos         , Ur          , Ur          , Ur          , Xos         , Xos         , Cud         , Cud         , Gg          , Gg          , Gg          , Cud         , Cud         , Gg          , Gg          , Gg          , Rr          , Gg          , Rr          , Gg          
Gg          , Gg          , Gg          , Gg^Uf       , Wwf         , Gg          , Ggf         , Gg          , Gg          , Gg          , Gg          , Cud         , Kud         , Cud         , Cud         , Cud         , Kud         , Cud         , Cud         , Cud         , Cud         , Cud         , Cud         , Kud         , Cud         , Cud         , Xos         , Kud         , Cud         , Ur          , Xos         , Xos         , Kud         , Cud         , Gg          , Gg          , Gg          , Gg          , Gg          , Gg          , Gg          , Cud         , Cud         , Cud         , Gg          , Rr          , Mm          , Rr          
Gg^Fet      , Gg          , Gg          , Wwf         , Gg          , Gs^Fp       , Mm          , Hh          , Gg          , Gg          , Rr          , Gg          , Rr          , Rr          , Gg          , Gg          , Gg          , Gg          , Gg          , Wwf         , Wwf         , Wwf         , Gg          , Gg          , Gg          , Gg          , Gg          , Xos         , Xos         , Cud         , Cud         , Cud         , Gg          , Gg          , Gg          , Gg          , Hh          , Hh          , Gs^Fp       , Gg          , Gg          , Gg          , Kud         , Cud         , Gg          , Gg          , Hh          , Gs^Fms      
Ggf         , Gg          , Wwf         , Wwf         , Gs^Fds      , Hh          , Gg          , Gg          , Rr          , Rr          , Gg          , Rr          , Gg          , Gs^Fds      , Gg          , Gg          , Gg          , Gg          , Gg          , Wwf         , Wwf         , Gg          , Gg          , Gs^Fp       , Gg          , Gg          , Gg          , Gg          , Gg          , Gg          , Gg          , Gg          , Gg          , Gg          , Gg          , Ggf         , Gs^Fp       , Mm          , Gg^Fet      , Gg          , Gg          , Gg          , Gg          , Gg          , Gg          , Gg          , Gg          , Gg          
Wwf         , Wwf         , Gg          , Gg          , Gg          , Gg          , Rr          , Rp^Vhc      , Gg          , Gg          , Gg          , Gg          , Gg          , Gg          , Mm          , Gg          , Gg          , Gg          , Wwf         , Wwf         , Gg          , Gg          , Gg          , Gg          , Gg          , Gg          , Gg          , Gg          , Gg          , Gg          , Gg          , Gg          , Gg          , Gg          , Gg          , Gg          , Gg          , Gg          , Gg          , Gg          , Gg          , Gg          , Gg          , Gg          , Gg          , Gg          , Gg^Vc       , Gs^Fds      
Gg          , Gg          , Rr          , Gg          , Rr          , Rr          , Gs^Fp       , Gg          , Gg          , Gs^Fp       , Hh          , Gs^Fp       , Hh          , Gg          , Ggf         , Hh          , Gg          , Gg          , Wwf         , Gg^Vc       , Gg          , Gg          , Gg          , Gg          , Gs^Fp       , Ggf         , Gs^Fds      , Gg          , Rr          , Rr          , Rr          , Gg          , Rr          , Gg          , Rr          , Rr          , Rr          , Gg^Vc       , Rr          , Gg          , Rr          , Rr          , Rr          , Ggf         , Gg          , Ggf         , Gs^Fds      , Hh          
Wwf         , Rr          , Gg^Fet      , Rr          , Gg          , Hh          , Hh          , Mm          , Gg^Uf       , Ggf         , Gs^Fp       , Mm          , Ww          , Gg          , Ww          , Ww          , Ww          , Wwf         , Hh          , Gg          , Gg^Fet      , Gg          , Gg          , Gg^Uf       , Hh          , Mm          , Hh          , Rr          , Gg          , Gg          , Gs^Fp       , Rr          , Hh          , Rr          , Gg          , Gg^Uf       , Ggf         , Rr          , Gg          , Rr          , Ggf         , Mm          , Hh          , Rr          , Rr          , Gs^Fp       , Gg^Uf       , Mm          
Hh          , Gg^Uf       , Gs^Fp       , Gg          , Gg^Uf       , Ggf         , Hh          , Gs^Fds      , Gs^Fp       , Ggf         , Ww          , Ww          , Wo          , Ww          , Wo          , Ww          , Wwf         , Wwf         , Ggf         , Mm          , Ggf         , Gs^Fp       , Rr          , Rr          , Rr          , Hh          , Rr          , Rr          , Gg          , Ggf         , Hh          , Mm          , Gs^Fp       , Gg          , Gg          , Gg          , Gg          , Gg          , Gg^Uf       , Gg          , Gg          , Gs^Fp       , Ggf         , Gg          , Gg^Uf       , Rr          , Mm          , Hh          
Gg^Uf       , Gs^Fds      , Hh          , Mm          , Hh          , Mm          , Mm          , Hh          , Mm          , Ww          , Ww          , Wo          , Wo          , Wo          , Wo          , Ww          , Mm          , Mm          , Mm          , Gg^Uf       , Wwf         , Rr          , Gg          , Gg^Uf       , Gg^Fet      , Rr          , Gg          , Gg          , Gg          , Gg^Uf       , Hh^Fds      , Gg^Fet      , Gg^Uf       , Gg^Uf       , Gg^Fet      , Gg          , Gg          , Hh^Fds      , Hh^Fds      , Gs^Fds      , Gg^Fet      , Hh          , Mm          , Hh^Fds      , Gs^Fp       , Rr          , Gg^Fet      , Mm          
