border_size=1
usage=map

Ms^Xo       , Gg^Xo       , Ms^Xo       , Ms^Xo       , Ms^Xo       , Aa          , Aa          , Aa          , Aa          , Aa          , Aa          , Aa          , Aa          , Aa          , Ha^Xo       , Aa          , Aa^Xo       , Aa          , Aa^Xo       , Aa          , Aa^Xo       , Aa          , Aa^Xo       , Aa          , Aa^Xo       , Ms          , Ms          , Ms^Fda      , Ms^Xo       , Ms          , Ms^Xo       , Ms          , Ms          
Aa          , Ms^Xo       , Ms^Xo       , Ms^Xo       , Aa          , Aa          , Gg          , Aa          , Aa^Fpa      , Aa          , Gg^Uf       , Aa          , Ms          , Ha          , Ha          , Ha          , Ww          , Wo          , Wo          , Wo          , Wo          , Wo          , Wo          , Wwr         , Wo          , Ms^Xo       , Ms^Xo       , Ms^Xo       , Ms^Xo       , Ms^Xo       , Ms^Xo       , Ms^Xo       , Rp          
Aa          , Ms^Xo       , Ha^Fpa      , Aa          , Aa          , Aa          , Gg          , Aa          , Gg          , Ha          , Ha^Fpa      , Gg^Uf       , Hh          , Gg          , Gs^Fms      , Hh^Fds      , Gg          , Wwr         , Gg          , Ha          , Aa          , Wo          , Aa          , Aa          , Aa^Fma      , Wo          , Wo          , Ms^Xo       , Ms^Xo       , Ms^Xo       , Rp          , Rp          , Ms^Xo       
Ai          , Ha^Fpa      , Aa          , Gg          , Gg          , Aa^Fpa      , Gg          , Gg          , Ss          , Ha          , Aa^Vca      , Gs^Fms      , Gg          , Gg          , Gg          , Hh          , Wwf         , Wwf         , Gg          , Gg          , Gg          , Ha          , Gg          , Aa^Fda      , Ha          , Ha          , Ha          , Wo          , Wwf         , Rp          , Ms^Xo       , Ms^Xo       , Ms          
Ha^Fpa      , Aa          , Aa^Fma      , Gg          , Ha          , Gg          , Gg          , Gg          , Gg          , Gg          , Gg          , Gg          , Re          , Re          , Re          , Wwf         , Wwf         , Gg          , Gg          , Gg          , Aa^Fmf      , Gg          , Gg          , Gg          , Gg          , Gg          , Rd          , Wwf         , Ww          , Ms^Xo       , Ms^Xo       , Ms^Xo       , Ms^Xo       
Ha^Fpa      , Gg          , Gg          , Gg          , Gg          , Hh^Vhh      , Gg          , Gg          , Gg          , Gg          , Ss          , Re          , Gg^Fmf      , Gg          , Wwf         , Wwf         , Gg          , Re          , Re          , Hh          , Mm          , Gs^Fms      , Gg          , Gg          , Rd          , Rd          , Gg          , Gg          , Ss          , Ww          , Ms^Xo       , Ms^Xo       , Ms^Xo       
Aa          , Aa          , Gg          , Gg          , Re^Gvs      , Gg          , Gs^Fmf      , Gg          , Ss          , Gg          , Hh^Fmf      , Re          , Hh          , Wwr         , Chw         , Gg^Uf       , Gg          , Gg          , Gg          , Re          , Re          , Gg          , Re          , Rd          , Gg^Uf       , Ha^Vhha     , Gg          , Gg          , Ss          , Ww          , Ww          , Ms^Xo       , Ms^Xo       
Ms          , Gg          , Gg          , Re^Gvs      , Gg^Wm       , Re^Gvs      , Gg          , Gg          , Rp          , Gg          , Re          , Re          , Mm^Xm       , Wo          , Mm^Xm       , Gg          , Ch          , Gg          , Gg          , Gg          , Gg^Ve       , Re          , Gg          , Gg          , Aa^Fpa      , Gg^Fda      , Gg          , Gg          , Wwr         , Ss          , Ww          , Wo          , Ai          
Aa          , Gg          , Gg          , Gg          , Gg          , Gg          , Gg          , Kv          , Gg          , Rp          , Rp          , Mm^Xm       , Ss^Vhs      , Ww          , Chw         , Gg          , Mm^Xm       , Hh          , Hh^Fds      , Gg          , Gg          , Re          , Gg          , Hh          , Gg          , Gg          , Gg          , Gg          , Ss^Vhs      , Ss          , Ww          , Wo          , Ai          
Aa          , Gg          , Gg          , Ha          , Ms          , Gg          , Gs^Fdf      , Cv          , Gg          , Gg          , Wwf         , Wwf         , Wwf         , Wwf         , Gg          , Gg          , Mm^Xm       , Mm          , Mm          , Gg          , Gg          , Re          , Mm          , Hh^Fdf      , Gg          , Gg          , Khr         , Khr         , Chw         , Chw         , Chw         , Wo          , Ai          
Aa^Fpa      , Gg          , Gg          , Gs^Fms      , Ss          , Gs^Fmf      , Gg          , Cv          , Kv          , Wwf         , Gs^Fdf      , Rp          , Wwf         , Gg          , Gg^Wm       , Hh          , Mm^Xm       , Mm^Xm       , Gg          , Gg          , Rp          , Re          , Gg          , Gs^Fp       , Gg          , Gg          , Gg          , Gg          , Mm          , Hh          , Ss          , Ww          , Ai          
Hh^Fms      , Gg          , Gg          , Gg          , Gg          , Gg          , Ww          , Gg          , Wwf         , Ww          , Wwf         , Rp          , Wwf         , Re^Gvs      , Re^Gvs      , Mm          , Mm^Xm       , Rp^Vhc      , Rp          , Rp          , Hh          , Gg          , Gg          , Gg          , Gg          , Gg          , Gs^Fmf      , Gg          , Gg          , Gs^Fp       , Hh          , Ww          , Ha^Fpa      
Gs^Fp       , Gg          , Gg          , Hh          , Ww          , Ww          , Ss          , Wwf         , Gg          , Gg          , Rp          , Wwf         , Mm^Xm       , Wwf         , Wwf         , Mm^Xm       , Mm          , Hh          , Rp          , Gg          , Gs^Fmf      , Hh          , Re^Gvs      , Re^Gvs      , Re^Gvs      , Rp^Vhc      , Hh          , Gs^Fdf      , Gg          , Gs^Fms      , Ss          , Ww          , Ww          
Gg          , Gs^Fms      , Gg          , Ww          , Ss          , Ss          , Gg          , Gg          , Gs^Fmf      , Gg          , Rp          , Mm^Xm       , Hh          , Mm^Xm       , Mm^Xm       , Mm^Xm       , Mm^Xm       , Hh          , Rr          , Gg          , Gg          , Gg          , Gg          , Gg^Wm       , Ggf         , Gg          , Gg          , Gg          , Gg          , Gg          , Ww          , Ww          , Gg          
Gg          , Gg          , Ww          , Wwf         , Gg          , Gg          , Gg          , Gg          , Hh          , Gs^Fdf      , Gg          , 1 Khr       , Ch          , Ch          , Kh          , Mm^Xm       , Ww          , Mm^Xm       , Kh          , Ch          , Ch          , Gg          , Gg          , Gg          , Hh          , Gg          , Gg          , Gg          , Gg          , Gg          , Ww          , Gg          , Gg          
Gg          , Gg          , Ww          , Gg          , Gg          , Gg          , Gg          , Gg          , Ggf         , Gg          , Gg          , Gg          , Gg          , Ch          , Rr          , Mm^Xm       , Mm^Xm       , Mm^Xm       , Mm^Xm       , Ch          , Hh          , 2 Khr       , Rp          , Gs^Fdf      , Gs^Fmf      , Gg          , Gg          , Gg          , Ss          , Wwf         , Gg          , Gg          , Gg          
Ww          , Ww          , Ss          , Gg          , Gg          , Gs^Fdf      , Hh          , Gg          , Re^Gvs      , Gg^Wm       , Re^Gvs      , Gg          , Gs^Fmf      , Gg          , Rp          , Hh          , Mm          , Mm^Xm       , Wwf         , Mm^Xm       , Mm^Xm       , Mm^Xm       , Rp          , Gg          , Gg          , Gg          , Ss          , Ss          , Ww          , Ww          , Gg          , Gs^Fp       , Gs^Fds      
Ww          , Ww          , Hh          , Gs^Fp       , Gg          , Gg          , Gs^Fmf      , Rp^Vhc      , Gg          , Re^Gvs      , Gg          , Hh          , Hh          , Gg          , Rp          , Hh          , Mm^Xm       , Mm^Xm       , Re^Gvs      , Wwf         , Wwf         , Wwf         , Wwf         , Gg          , Wwf         , Wwf         , Ww          , Ww          , Gg          , Hh          , Gg          , Gg          , Hh^Fp       
Ww          , Ww          , Ss          , Gs^Fms      , Mm          , Gg          , Gg          , Gg          , Gg          , Gg          , Gg          , Gg          , Rp          , Rp          , Gg          , Rp^Vhc      , Md^Xm       , Mm          , Gg^Wm       , Re^Gvs      , Wwf         , Rp          , Gs^Fmf      , Wwf         , Ke          , Gg          , Gg          , Gg          , Ss          , Gg          , Gg          , Gg          , Gs^Fdf      
Ww          , Ww          , Chw         , Hh          , Chw         , Gg          , Khr         , Gg          , Gg          , Gs^Fds      , Mm          , Rd          , Gg          , Gg          , Md          , Md^Xm       , Md^Xm       , Hh          , Gg          , Gg          , Wwf         , Rp          , Wwf         , Wwf         , Gg          , Ce          , Gs^Ft       , Gs^Ft       , Md          , Gs^Ft       , Gg          , Gg          , Gs^Ft       
Hd          , Wo          , Ww          , Chw         , Ss^Vhs      , Khr         , Gg          , Gg          , Gg          , Hh^Fdf      , Gg          , Rd          , Gg          , Gg          , Hh^Fds      , Md          , Md^Xm       , Gg          , Chw         , Wwf         , Ss^Vhs      , Wwf         , Rp          , Gg          , Gg          , Ce          , Gg          , Gg          , Gg          , Hd          , Gg          , Gg          , Gs^Ft       
Hd          , Wo          , Ww          , Ss          , Wwr         , Gg          , Gg          , Gg          , Gs^Ft       , Hh          , Gg          , Rd          , Gg^Ve       , Gg          , Gg          , Hh          , Chr         , Gg          , Md^Xm       , Ww          , Md^Xm       , Md^Xm       , Rd          , Rp          , Rp          , Ke          , Gg          , Gg          , Gg^Wm       , Gg          , Gg          , Gg          , Dd^Do       
Hd          , Wo          , Ww          , Ss          , Ss          , Gg          , Gg          , Gs^Ft       , Ds^Uf       , Gg          , Rd          , Rd          , Rd          , Gg          , Gg          , Gg          , Gg          , Gg          , Chw         , Wo          , Hh          , Rd          , Hh^Ft       , Gg          , Ss          , Gg          , Gs^Ft       , Re^Gvs      , Re^Gvs      , Re^Gvs      , Gg          , Gg          , Ds          
Md^Xo       , Md^Xo       , Md^Xo       , Ww          , Ss          , Gg          , Gg          , Dd^Vda      , Rd          , Rd          , Gg          , Gg          , Md          , Rd          , Rd          , Gg          , Gg          , Gg^Uf       , Wwf         , Wwr         , Gg^Ft       , Rd          , Ss          , Gg          , Gg          , Gg          , Gg          , Gg          , Gg          , Gg          , Gg          , Ds          , Ds          
Md          , Md^Xo       , Md^Xo       , Ww          , Ww          , Gg          , Rd          , Rd          , Gg          , Gg          , Gg          , Gs^Ft       , Dd^Ft       , Hd          , Gg          , Rd          , Wwf         , Wwf         , Rd          , Gg          , Rd          , Rd          , Gg          , Gg          , Gg          , Gg          , Gg          , Hh^Vc       , Hh          , Gg          , Ds          , Gg          , Ds          
Md          , Hd^Xo       , Md^Xo       , Md^Xo       , Wwf         , Wwf         , Hd          , Gg          , Hd          , Gg          , Gg          , Gg          , Gg          , Gg          , Gg          , Gg          , Wwf         , Wwf         , Gg          , Rd          , Gg          , Gg          , Dd^Vdt      , Gg          , Ss          , Gg          , Ds          , Gg          , Ds          , Gg          , Ds^Ft       , Ds          , Md          
Md^Xo       , Md^Xo       , Rp          , Rp          , Md^Xo       , Wo          , Wo          , Hd          , Ds^Ft       , Ds^Ft       , Ds          , Hd          , Ds          , Gg          , Gg          , Wwf         , Gg          , Hh          , Gg^Ft       , Gg          , Hh          , Gg^Ft       , Hd^Ft       , Hd          , Gg          , Gg          , Ds          , Ds^Ft       , Ds          , Gg          , Hd          , Hd          , Md^Xo       
Rp          , Rp          , Md^Xo       , Md^Xo       , Md^Xo       , Md^Xo       , Md^Xo       , Wo          , Wo          , Ds          , Wo          , Wo          , Wo          , Hd          , Wo          , Wwr         , Ww          , Hd^Ft       , Hd          , Gg          , Md          , Gg^Uf       , Gg^Uf       , Hd          , Gg          , Ds^Ft       , Gg          , Ds          , Ds^Dr       , Ds          , Hd          , Md^Xo       , Md^Xo       
Md^Xo       , Md^Xo       , Hd^Xo       , Hd^Xo       , Md^Xo       , Md^Xo       , Md^Xo       , Md^Xo       , Md^Xo       , Wwr         , Md^Xo       , Wo          , Md^Xo       , Wo          , Md^Xo       , Wo          , Md^Xo       , Hd          , Md^Xo       , Hd          , Md^Xo       , Ds          , Md^Xo       , Ds          , Md^Xo       , Ds          , Md^Xo       , Ds^Dr       , Md^Xo       , Hd          , Md^Xo       , Md^Xo       , Md^Xo       
Md^Xm       , Md^Xo       , Hd^Xo       , Hd^Xo       , Md          , Md^Xo       , Md          , Md          , Md          , Md^Xo       , Md          , Md^Xo       , Md          , Md^Xo       , Md          , Md^Xo       , Md          , Md^Xo       , Md          , Md^Xo       , Md          , Md^Xo       , Md          , Md^Xo       , Md          , Md^Xo       , Md          , Md^Xo       , Md          , Md^Xo       , Md^Xo       , Md^Xo       , Gg          
