border_size=1
usage=map

Xv          , Xv          , Xv          , Xv          , Xv          , Xv          , Xv          , Xv          , Xv          , Xv          , Xv          , Xv          , Xv          , Xv          , Xv          , Xv          , Xv          , Xv          , Xv          , Xv          , Xv          , Xv          , Xv          , Xv          , Xv          , Xv          , Xv          
Xv          , Xv          , Xv          , Xv          , Xv          , Xv          , Xv          , Xv          , Xv          , Xv          , Gg^Fp       , Rp          , Rp          , Gg          , Gg          , Xv          , Xv          , Xv          , Xv          , Xv          , Xv          , Xv          , Xv          , Xv          , Xv          , Xv          , Xv          
Xv          , Xv          , Xv          , Xv          , Xv          , Xv          , Xv          , Xv          , Ww          , Gg^Fet      , Hh          , 2 Kh        , Rp          , Gg^Fp       , Gg^Fp       , Gg          , Rp          , Xv          , Xv          , Xv          , Xv          , Xv          , Xv          , Xv          , Xv          , Xv          , Xv          
Xv          , Xv          , Xv          , Xv          , Xv          , Xv          , Wwf         , Wwf         , Wwf         , Ww^Vm       , Ggf         , Ch          , Rp          , Mm          , Hh          , Rp          , Hh^Vhh      , Hh          , Mm          , Xv          , Xv          , Xv          , Xv          , Xv          , Xv          , Xv          , Xv          
Xv          , Xv          , Xv          , Xv          , Xv          , Wwf         , Gg^Fp       , Gg^Fp       , Hh          , Wwf         , Wwf         , Ch          , Chw         , Rp          , Rp          , Rp          , Rp          , Gg^Fp       , Gg^Fp       , Xv          , Xv          , Xv          , Xv          , Xv          , Xv          , Xv          , Xv          
Xv          , Xv          , Xv          , Xv          , Wwf         , Wwf         , Ss          , Ss^Vhs      , Ggf         , Mm          , Gg          , Chw         , Gg          , Wwf         , Wwf         , Wwf         , Wwf         , Rp          , Ss          , Gs          , Gs          , Xv          , Xv          , Xv          , Xv          , Xv          , Xv          
Xv          , Xv          , Ww          , Wwf         , Gg^Fp       , Ggf         , Gg          , Ggf         , Gg          , Gg          , Ggf         , Ggf         , Gg^Ve       , Gg          , Gg          , Gg^Fet      , Ww^Bw/      , Rp          , Rp          , Gs          , Gg^Fp       , Ss          , Gg^Fet      , Xv          , Xv          , Xv          , Xv          
Xv          , Hh^Uf       , Wwf         , Wwf         , Gg          , Ce          , Gg          , Gg          , Gg          , Gg          , Gg          , Xu          , Xu          , Xu          , Rp          , Rp          , Wwf         , Hh          , Gg^Fp       , Rp          , Rp^Vhc      , Hh          , Ww^Bw/      , Ww          , Ww          , Xv          , Xv          
Xv          , Ww^Bw|      , Wwf         , Gg          , Rp          , Gg          , Hh          , Ss          , Gg          , Gg^Fp       , Gg^Fp       , Gg          , Gg          , Rp          , Uh          , Ggf^Fp      , Wwf         , Gg          , Gg          , Rp          , Rp          , Ww^Bw\      , Mm          , Ww^Bw\      , Ww^Bw\      , Xv          , Xv          
Xv          , Ww^Bw\      , Ww^Bw/      , Rp^Vhc      , Hh^Uf       , Rp          , Rp          , Gg^Fp       , Gg          , Mm          , Xu          , Ww          , Ww          , Cud         , Xu          , Uu^Vud      , Gg          , Chw         , Wwf         , Gg          , Rp^Fp       , Wwf         , Wwf         , Hh^Fms      , Ww^Bw|      , Xv          , Xv          
Xv          , Wwf         , Ww^Bw|      , Gg^Fet      , Wo          , Mm^Xm       , Ss          , Rp          , Gg          , Hh^Uf       , Xu          , Hh^Uf       , Wwf         , Xu          , Gg^Fet      , Gg          , Wwf         , Gg^Fp       , Ww          , Gg          , Rp          , Chw         , Wo          , Wwr         , Ww^Bw|      , Ww          , Xv          
Xv          , Wwf         , Ww^Bw|      , Wo^Bw\      , Wo          , Wwf         , Rp          , Rp          , Ww          , Wwf         , Wwf         , Ww^Bw|      , Gg^Fet      , Ggf         , Ww^Bw\      , Wwf         , Xu          , Wwf         , Ggf         , Rp          , Ss          , Wwf         , Wo          , Wo^Bw\      , Ww^Bw|      , Wwf         , Xv          
Xv          , Ww          , Ww^Bw|      , Wwr         , Wwf         , Chw         , Rp^Fp       , Gg          , Wwf         , Gg^Fp       , Gg          , Gg          , Xu          , Xu          , Ww          , Hh^Uf       , Xu          , Hh^Uf       , Gg          , Rp          , Rp          , Mm^Xm       , Hh^Uf       , Gg^Fet      , Ww^Bw/      , Wwf         , Xv          
Xv          , Xv          , Ww^Bw\      , Hh^Fms      , Mm          , Wwf         , Rp          , Gg          , Gg          , Chw         , Wwf         , Uu^Vud      , Uh          , Cud         , Gg          , Ww          , Gg^Fp       , Mm          , Hh          , Gg^Fp       , Gg          , Rp          , Rp          , Rp^Vhc      , Ww^Bw\      , Wwf         , Xv          
Xv          , Xv          , Ww          , Ww^Bw\      , Ww^Bw/      , Ww^Bw\      , Rp^Vhc      , Rp          , Gg^Fp       , Gg          , Wwf         , Gg^Fp       , Rp          , Rp          , Xu          , Gg          , Gg          , Gg^Fp       , Gg          , Ss          , Gg          , Gg          , Gg          , Gg          , Wwf         , Ww^Bw|      , Xv          
Xv          , Xv          , Xv          , Ww          , Gg^Fet      , Hh          , Gg^Fp       , Rp          , Rp          , Hh          , Ww^Bw/      , Rp          , Gg          , Xu          , Gg^Ve       , Xu          , Ggf         , Gg          , Gg          , Gg          , Hh          , Ce          , Gg^Fp       , Wwf         , Ww          , Hh^Uf       , Xv          
Xv          , Xv          , Xv          , Xv          , Xv          , Ss          , Gs          , Gs          , Ss          , Rp          , Wwf         , Gg^Fet      , Wwf         , Gg          , Gg          , Ggf         , Gg          , Gg          , Ggf         , Gg          , Ss          , Ggf         , Wwf         , Wwf         , Xv          , Xv          , Xv          
Xv          , Xv          , Xv          , Xv          , Xv          , Xv          , Xv          , Gs          , Gg^Fp       , Rp          , Rp          , Wwf         , Rp          , Wwf         , Chw         , Chw         , Wwf         , Mm          , Hh          , Ss^Vhs      , Gg^Fp       , Wwf         , Xv          , Xv          , Xv          , Xv          , Xv          
Xv          , Xv          , Xv          , Xv          , Xv          , Xv          , Xv          , Xv          , Mm          , Gg^Fp       , Hh^Vhh      , Rp          , Hh          , Rp          , Rp          , Ch          , Ggf         , Wwf         , Wwf         , Gg^Fp       , Wwf         , Wwf         , Xv          , Xv          , Xv          , Xv          , Xv          
Xv          , Xv          , Xv          , Xv          , Xv          , Xv          , Xv          , Xv          , Xv          , Hh          , Rp          , Rp          , Gg^Fp       , Mm          , Rp          , Ch          , Hh          , Ww^Vm       , Ww          , Wwf         , Xv          , Xv          , Xv          , Xv          , Xv          , Xv          , Xv          
Xv          , Xv          , Xv          , Xv          , Xv          , Xv          , Xv          , Xv          , Xv          , Xv          , Xv          , Gg          , Gg          , Gg^Fp       , Rp          , 1 Kh        , Gg^Fp       , Gg^Fet      , Xv          , Xv          , Xv          , Xv          , Xv          , Xv          , Xv          , Xv          , Xv          
Xv          , Xv          , Xv          , Xv          , Xv          , Xv          , Xv          , Xv          , Xv          , Xv          , Xv          , Xv          , Xv          , Gg          , Xv          , Rp          , Xv          , Xv          , Xv          , Xv          , Xv          , Xv          , Xv          , Xv          , Xv          , Xv          , Xv          
Xv          , Xv          , Xv          , Xv          , Xv          , Xv          , Xv          , Xv          , Xv          , Xv          , Xv          , Xv          , Xv          , Xv          , Xv          , Xv          , Xv          , Xv          , Xv          , Xv          , Xv          , Xv          , Xv          , Xv          , Xv          , Xv          , Xv          
