border_size=1
usage=map

_off^_usr   , _off^_usr   , _off^_usr   , _off^_usr   , _off^_usr   , _off^_usr   , _off^_usr   , _off^_usr   , _off^_usr   , _off^_usr   , _off^_usr   , _off^_usr   , _off^_usr   , _off^_usr   , _off^_usr   , _off^_usr   , _off^_usr   , _off^_usr   , _off^_usr   , _off^_usr   , _off^_usr   , _off^_usr   , _off^_usr   , _off^_usr   , _off^_usr   , _off^_usr   , _off^_usr   , _off^_usr   , _off^_usr   , _off^_usr   , _off^_usr   , _off^_usr   , _off^_usr   
_off^_usr   , _off^_usr   , _off^_usr   , _off^_usr   , _off^_usr   , _off^_usr   , _off^_usr   , _off^_usr   , Gg          , Ss          , Hh          , Hh          , Gs^Fds      , Mm          , Hh^Uf       , Hh          , Gg          , Ss          , Gs^Fms      , Mm          , Gg          , _off^_usr   , _off^_usr   , _off^_usr   , _off^_usr   , _off^_usr   , _off^_usr   , _off^_usr   , _off^_usr   , _off^_usr   , _off^_usr   , _off^_usr   , _off^_usr   
_off^_usr   , _off^_usr   , _off^_usr   , _off^_usr   , _off^_usr   , _off^_usr   , Gg          , Gg          , Gg          , Gg          , Gg          , Gg          , Gg          , Gs^Fds      , Gg          , Gg          , 1 Kh        , Gg          , Gg          , Gg          , Gg^Vh       , Gg          , Gg          , _off^_usr   , _off^_usr   , _off^_usr   , _off^_usr   , _off^_usr   , _off^_usr   , _off^_usr   , _off^_usr   , _off^_usr   , _off^_usr   
_off^_usr   , _off^_usr   , _off^_usr   , _off^_usr   , Gg          , Gg          , Gg          , Gs^Fp       , Hh          , Mm          , Gg          , Gg          , Gg          , Gg          , Ch          , Ch          , Ch          , Ch          , Ch          , Gg          , Gg          , Gg          , Gs^Fmf      , Mm          , Gg          , _off^_usr   , _off^_usr   , _off^_usr   , _off^_usr   , _off^_usr   , _off^_usr   , _off^_usr   , _off^_usr   
_off^_usr   , _off^_usr   , Gg          , Gg          , Gg          , Gs^Fp       , Hh          , Gg          , Gg          , Hh^Fms      , Gg          , Gg          , Rr          , Kh          , Gg          , Gg          , Ds          , Gg          , Gg          , Kh          , Rr          , Gg          , Gg          , Gg          , Hh          , Gg          , Gg          , _off^_usr   , _off^_usr   , _off^_usr   , _off^_usr   , _off^_usr   , _off^_usr   
_off^_usr   , _off^_usr   , Gg          , Ss^Vhs      , Ss          , Gg          , Gg          , Gg          , Gg          , Gg          , Rp^Vhc      , Rr          , Gg          , Gg          , Ww          , Ww          , Ww          , Ww          , Ww          , Gg          , Gg          , Rr          , Rr          , Gg^Vh       , Gg          , Gg          , Gg          , Hh          , Ss          , _off^_usr   , _off^_usr   , _off^_usr   , _off^_usr   
_off^_usr   , _off^_usr   , Gg          , Ss^Uf       , Hh^Fdf      , Mm          , Gg          , Gg          , Rr          , Rr          , Rr          , Gg          , Gg^Ft       , Ww          , Wo          , Wo          , Wo          , Wo          , Wo          , Ww          , Hh          , Gg          , Rr          , Rr          , Rr          , Gg^Fet      , Gg          , Gg          , Gg          , Gg          , Mm          , _off^_usr   , _off^_usr   
_off^_usr   , _off^_usr   , Mm^Xm       , Gg          , Gg          , Gg          , Gg          , Rr          , Gg          , Gg          , Mm          , Rr          , Wo^Bw\      , Wo          , Wo          , Wo          , Ss          , Wo          , Wo          , Wo          , Wo^Bw/      , Rr          , Gg          , Gg          , Gg          , Rr          , Rr          , Gg          , Hh^Fmw      , Gg          , Ss^Uf       , _off^_usr   , _off^_usr   
_off^_usr   , _off^_usr   , Mm^Xm       , Gg          , Gg          , Gs^Fds      , Gg          , Gg^Ve       , Gg          , Hh          , Mm^Xm       , Mm^Xm       , Wo          , Wo^Bw\      , Gs          , Hh^Fmf      , Ss^Vhs      , Gs^Uf       , Gs          , Wo^Bw/      , Wo          , Mm^Xm       , Mm^Xm       , Gs^Fmw      , Gg          , Gg          , Rp^Vhc      , Gg          , Gg          , Gg          , Gg          , _off^_usr   , _off^_usr   
_off^_usr   , _off^_usr   , Mm^Xm       , Mm^Xm       , Gg          , Gg          , Gg          , Gg          , Gg          , Gg          , Gg          , Mm^Xm       , Wo          , Ww          , Gs^Uf       , Gs          , Gs          , Gs          , Hh          , Ww          , Wo          , Mm^Xm       , Hh          , Mm^Xm       , Gg          , Gg          , Gg          , Gg          , Gg          , Gg          , Gg          , _off^_usr   , _off^_usr   
_off^_usr   , _off^_usr   , Hh          , Ss          , Gg          , Gg          , Gs^Fp       , Gg          , Gg          , Hh          , Gg^Fet      , Gg          , Ww^Bw/      , Ww^Bw/      , Gs          , Gs^Ft       , Gs          , Gs          , Gs          , Ww^Bw\      , Ww^Bw\      , Gg          , Gg          , Gg          , Gg          , Gg^Wm       , Gg          , Gg          , Hh          , Gs^Fp       , Gg          , _off^_usr   , _off^_usr   
_off^_usr   , _off^_usr   , Gg          , Gg          , Gg          , Mm          , Hh          , Hh^Uf       , Gg          , Gg          , Gg          , Gg          , Ww          , Ww          , Wo          , Hh          , Wwf         , Gs^Uf       , Wo          , Wo          , Wwf         , Ss          , Mm          , Hh          , Gg          , Gg          , Gg          , Gg          , Ss          , Mm          , Gg          , _off^_usr   , _off^_usr   
_off^_usr   , _off^_usr   , Gg          , Gs^Fmw      , Gg          , Hh          , Hh^Uf       , Gs^Fmf      , Gg          , Ss          , Gg          , Hh          , Wo          , Wo          , Wo          , Ww          , Chw         , Wwf         , Wo          , Wo          , Wo          , Wwf         , Gg          , Ss^Fp       , Gg          , Hh          , Hh^Uf       , Gg          , Gg          , Gg          , Gg          , _off^_usr   , _off^_usr   
_off^_usr   , _off^_usr   , Gg          , Gg          , Ss          , Gg          , Gg          , Hh          , Gg          , Ss^Fp       , Mm          , Wwf         , Wwf         , Wo          , Wo          , Wwf         , Wwf         , Ww          , Wo          , Wo          , Ww          , Hh          , Gg          , Ss          , Gg          , Gs^Fmf      , Hh          , Hh          , Gg          , Gs^Fmw      , Gg          , _off^_usr   , _off^_usr   
_off^_usr   , _off^_usr   , Gg          , Mm          , Hh          , Gg          , Gg          , Gg          , Gg          , Hh          , Gg          , Ss          , Ww^Bw\      , Wo          , Gs          , Gs^Uf       , Gs          , Hh          , Gs          , Ww          , Ww^Bw/      , Gg          , Gg^Fet      , Gg          , Gg          , Hh^Uf       , Gs^Fp       , Mm          , Gg          , Gg          , Hh          , _off^_usr   , _off^_usr   
_off^_usr   , _off^_usr   , Gg          , Gs^Fp       , Gg          , Gg          , Gg          , Gg^Wm       , Gg          , Gg          , Hh          , Gg          , Wo          , Ww^Bw\      , Hh          , Gs          , Gs          , Gs^Ft       , Gs^Uf       , Ww^Bw/      , Wo          , Gg          , Gg          , Hh          , Gg          , Gg          , Gg          , Gg          , Gg          , Ss          , Mm^Xm       , _off^_usr   , _off^_usr   
_off^_usr   , _off^_usr   , Gg          , Gg          , Gg          , Gg          , Rp^Vhc      , Gg          , Gg          , Mm^Xm       , Mm^Xm       , Mm^Xm       , Wo          , Ww          , Gs          , Gs          , Ss^Vhs      , Gs          , Gs          , Ww          , Wo          , Mm^Xm       , Mm^Xm       , Gg          , Gg          , Gg          , Gg          , Gg          , Gg          , Mm^Xm       , Mm^Xm       , _off^_usr   , _off^_usr   
_off^_usr   , _off^_usr   , Ss^Uf       , Gg          , Hh^Fmw      , Gg          , Rr          , Gg          , Gg          , Gs^Fmw      , Gg          , Mm^Xm       , Wo^Bw/      , Wo^Bw/      , Wo          , Gs^Uf       , Ss          , Hh^Fmf      , Wo          , Wo^Bw\      , Wo^Bw\      , Mm^Xm       , Mm          , Hh          , Gg          , Gg^Ve       , Gg          , Gs^Fds      , Gg          , Gg          , Mm^Xm       , _off^_usr   , _off^_usr   
_off^_usr   , _off^_usr   , Mm          , Gg          , Gg          , Gg          , Gg          , Rr          , Rr          , Gg          , Rr          , Rr          , Hh          , Wo          , Wo          , Wo          , Wo          , Wo          , Wo          , Wo          , Gg^Ft       , Rr          , Rr          , Gg          , Rr          , Rr          , Gg          , Ggf         , Gg          , Gg          , Hh          , _off^_usr   , _off^_usr   
_off^_usr   , _off^_usr   , _off^_usr   , Gg          , Ss          , Gg          , Gg          , Gg^Fet      , Gg          , Rr          , Rr          , Gg          , Gg          , Ww          , Ww          , Wo          , Ww          , Wo          , Ww          , Ww          , Gg          , Gg          , Rp^Vhc      , Rr          , Gg          , Gg          , Ss^Fdf      , Mm          , Hh          , Gg          , Gs^Fms      , _off^_usr   , _off^_usr   
_off^_usr   , _off^_usr   , _off^_usr   , _off^_usr   , _off^_usr   , Hh          , Gg          , Gg          , Hh          , Gg^Vh       , Gg          , Rr          , Rr          , Gg          , Gg          , Ww          , Ds          , Ww          , Gg          , Gg          , Rr          , Rr          , Gg          , Gg          , Gg          , Gg          , Gg          , Ss          , Ss^Uf       , Gg          , Mm          , _off^_usr   , _off^_usr   
_off^_usr   , _off^_usr   , _off^_usr   , _off^_usr   , _off^_usr   , _off^_usr   , _off^_usr   , Gg          , Gg          , Gg          , Gs^Fmf      , Gg          , Gg          , Kh          , Ch          , Gg          , Ch          , Gg          , Ch          , Kh          , Gg          , Gg          , Gg          , Hh^Fms      , Hh          , Gg          , Gg          , Ss^Vhs      , Gg          , Gg          , _off^_usr   , _off^_usr   , _off^_usr   
_off^_usr   , _off^_usr   , _off^_usr   , _off^_usr   , _off^_usr   , _off^_usr   , _off^_usr   , _off^_usr   , _off^_usr   , Mm          , Gg          , Gg          , Gg^Vh       , Gg          , Gg          , Ch          , 2 Kh        , Ch          , Gg          , Gg          , Gg          , Gg          , Gg          , Mm          , Gg          , Gs^Fp       , Gg          , Gg          , _off^_usr   , _off^_usr   , _off^_usr   , _off^_usr   , _off^_usr   
_off^_usr   , _off^_usr   , _off^_usr   , _off^_usr   , _off^_usr   , _off^_usr   , _off^_usr   , _off^_usr   , _off^_usr   , _off^_usr   , _off^_usr   , Gg          , Gg          , Gg          , Gs^Fms      , Gg          , Gg          , Gg          , Hh^Uf       , Gs^Fds      , Gs^Fds      , Gg          , Hh          , Gg          , Gg          , Gg          , _off^_usr   , _off^_usr   , _off^_usr   , _off^_usr   , _off^_usr   , _off^_usr   , _off^_usr   
_off^_usr   , _off^_usr   , _off^_usr   , _off^_usr   , _off^_usr   , _off^_usr   , _off^_usr   , _off^_usr   , _off^_usr   , _off^_usr   , _off^_usr   , _off^_usr   , _off^_usr   , Mm          , _off^_usr   , Ss          , _off^_usr   , Hh          , _off^_usr   , Mm          , _off^_usr   , Hh          , _off^_usr   , Ss          , _off^_usr   , _off^_usr   , _off^_usr   , _off^_usr   , _off^_usr   , _off^_usr   , _off^_usr   , _off^_usr   , _off^_usr   
_off^_usr   , _off^_usr   , _off^_usr   , _off^_usr   , _off^_usr   , _off^_usr   , _off^_usr   , _off^_usr   , _off^_usr   , _off^_usr   , _off^_usr   , _off^_usr   , _off^_usr   , _off^_usr   , _off^_usr   , _off^_usr   , _off^_usr   , _off^_usr   , _off^_usr   , _off^_usr   , _off^_usr   , _off^_usr   , _off^_usr   , _off^_usr   , _off^_usr   , _off^_usr   , _off^_usr   , _off^_usr   , _off^_usr   , _off^_usr   , _off^_usr   , _off^_usr   , _off^_usr   
