border_size=1
usage=map

Aa^Fpa      , Aa^Fpa      , Aa^Fpa      , Aa^Fpa      , Aa^Fpa      , Ha          , Rr          , Ha          , Ai          , Ai          , Ww          , Aa          , Ha          , Ha          , Ha          , Ms          , Ms          , Aa^Fpa      , Aa^Fpa      , Aa^Fpa      , Aa          , Aa          , Aa          , Aa          , Aa^Fpa      , Ai          , Ai          
Aa^Fpa      , Aa^Fpa      , Ha          , Aa^Fpa      , Aa          , Re^Uf       , Gg          , Rr          , Gs^Fp       , Ai          , Ww          , Ww          , Cv          , 1 Kv        , Cv          , Aa^Fpa      , Hh          , Aa^Vha      , Aa          , Aa          , Aa          , Aa^Fpa      , Hh          , Ww          , Ai          , Ai          , Ai          
Aa^Fpa      , Aa^Fpa      , Aa          , Aa          , Aa^Vea      , Gg          , Gg          , Rr          , Rr          , Ww          , Ww^Bw/      , Cv          , Rr          , Cv          , Rr          , Cv          , Rr          , Rr          , Rr          , Gg          , Gs^Fp       , Mm          , Hh          , Ww          , Ww          , Ai          , Aa^Fpa      
Aa          , Gg          , Hh          , Gg          , Gg          , Gg          , Wwf         , Re^Uf       , Ww          , Ww^Bw\      , Ww          , Ggf         , Gg^Vh       , Rr          , Re^Gvs      , Re^Gvs      , Ww          , Hh          , Rr          , Re^Uf       , Ww          , Gg          , Ww          , Ww          , Ww          , Aa^Fpa      , Aa^Fpa      
Ha          , Gg          , Gg          , Gg          , Gg          , Gg          , Ww          , Ww          , Ww          , Ww          , Ww          , Gs^Fp       , Ggf         , Rr          , Re^Gvs      , Re^Gvs      , Re^Gvs      , Ww          , Gg          , Rr          , Wwf         , Ww          , Ww          , Ww          , Aa          , Gg          , Aa^Fpa      
Ha          , Aa          , Gg          , Gg          , Gg          , Ww          , Wwf         , Ww          , Gg          , Hh          , Gg          , Gg          , Gg          , Rr          , Gg^Wm       , Re^Gvs      , Gg          , Gs^Fp       , Ww          , Wwf         , Wwf         , Wwf         , Gg^Vh       , Ai          , Aa          , Aa          , Ha          
Ha          , Re^Uf       , Chr         , Hh          , Gg          , Gs^Fp       , Wwf         , Wwf         , Wwf         , Gg^Vh       , Gg          , Gg          , Gg          , Rr          , Mm          , Gs^Fmw      , Gg          , Ss^Vhs      , Ww          , Wwf         , Rr          , Gg^Fet      , Gg          , Gg          , Gg          , Aa          , Ha          
Aa          , Aa          , Aa^Vha      , Gs^Fp       , Gg          , Gg          , Ww          , Ww          , Gs^Fmw      , Gg          , Gg          , Gg          , Gg          , Rr          , Hh          , Hh          , Gg          , Ww          , Ww          , Ww          , Hh          , Rr          , Gg          , Gg          , Ha          , Aa          , Aa          
Aa          , Gg          , Gg          , Gg          , Gg          , Ww          , Ww          , Ww          , Mm          , Hh          , Rr          , Gs^Fmw      , Rr          , Rr          , Gg          , Gg          , Gg          , Gs^Fmw      , Ww          , Ww          , Gg          , Rr          , Gg          , Gg          , Re^Uf       , Aa^Fpa      , Aa          
Aa^Fpa      , Aa          , Gg          , Gg          , Gg          , Hh          , Wwf         , Ww          , Rr          , Rr          , Gg          , Rr          , Gg          , Rr          , Gg          , Gg^Ve       , Gg          , Ww          , Ww          , Ww          , Gg          , Rr          , Gg          , Gg          , Gg          , Gg          , Ha          
Aa^Fpa      , Gs^Fp       , Hh          , Ggf         , Ggf         , Gg          , Chw         , Ww^Bw/      , Ww          , Gg          , Gs^Fdw      , Gg          , Gg          , Rr          , Gg          , Gs^Fdw      , Gs^Fdw      , Ww          , Ww          , Hh          , Rr          , Rr          , Mm          , Hh          , Gg          , Gg          , Ha          
Aa          , Ggf         , Gg          , Ggf         , Ggf         , Gg          , Rp          , Wwf         , Ww          , Ww          , Ss          , Hh          , Wwf         , Wwf         , Wwf         , Chs         , Ss          , Ss          , Ww          , Gg          , Rr          , Gg          , Gs^Fp       , Hh          , Gs^Fp       , Gg          , Aa          
Ms          , Gg          , Gs^Fp       , Gg          , Gs^Fp       , Gg          , Rp          , Gs^Fmw      , Ww          , Ww          , Ss          , Ss          , Wwf         , Hh^Fmw      , Wwf         , Ss          , Ss          , Ww          , Ww          , Gs^Fmw      , Rr          , Gg          , Gg          , Gg          , Gg          , Gg          , Ms          
Ms          , Gg          , Gg          , Hh          , Mm          , Gg          , Rp          , Gg          , Ww          , Ss          , Gs^Fdw      , Chs         , Gg          , Wwf         , Gg          , Hh          , Gs^Fdw      , Ww          , Ww          , Wwf         , Chw         , Gg          , Ggf         , Ggf         , Hh          , Ggf         , Ha          
Aa          , Gg          , Gg          , Hh          , Gg          , Rp          , Gg          , Hh          , Ww          , Ww          , Gg          , Gs^Fdw      , Gg          , Rp          , Gg          , Gg          , Gg          , Gg          , Rp          , Ww^Bw/      , Wwf         , Gg          , Gg          , Ggf         , Gg          , Gs^Fp       , Aa          
Ha          , Gg          , Re^Uf       , Gg          , Gg          , Rp          , Gg          , Ww          , Ww          , Ww          , Gg          , Gg^Ve       , Gg          , Rp          , Rp          , Rp          , Rp          , Rp          , Mm          , Ww          , Ww          , Hh          , Gg          , Gg          , Gg          , Aa          , Aa          
Ha          , Aa^Fpa      , Ha          , Gg          , Gg          , Rp          , Hh          , Ww          , Ww          , Gs^Fmw      , Gg          , Gg          , Hh          , Rp          , Gg          , Gs^Fmw      , Gg          , Hh          , Gs^Fmw      , Ww          , Ww          , Ww          , Gg          , Gg          , Aa^Vha      , Gg          , Aa          
Ha          , Aa          , Gg          , Gg          , Gg          , Rp          , Rp          , Ww          , Ww          , Ww          , Gg          , Hh          , Mm          , Rp          , Gg          , Gg          , Gg          , Gg          , Wwf         , Ww          , Wwf         , Gg          , Gg          , Gs^Fp       , Chr         , Aa          , Ha          
Ms          , Aa          , Aa          , Gg          , Gg^Vh       , Gs^Fp       , Wwf         , Wwf         , Ww          , Ss^Vhs      , Gg          , Gs^Fmw      , Gg^Wm       , Rp          , Gg          , Gg          , Gg          , Gg^Vh       , Gg          , Wwf         , Wwf         , Gs^Fp       , Gg          , Hh          , Gg          , Re^Uf       , Ha          
Aa^Fpa      , Aa          , Aa          , Ai          , Ww          , Wwf         , Wwf         , Wwf         , Gg          , Gs^Fp       , Re^Gvs      , Re^Gvs      , Re^Gvs      , Rp          , Ggf         , Gg          , Ww          , Hh          , Ww          , Ww          , Ww          , Ww          , Gg          , Gg          , Gg          , Aa          , Ha          
Aa^Fpa      , Gg          , Ww          , Ww          , Ww          , Ww          , Ww          , Rp          , Rp          , Ww          , Ww          , Re^Gvs      , Re^Gvs      , Rp          , Gg^Vh       , Gs^Fp       , Ww          , Ww          , Ww          , Ww          , Wwf         , Gg          , Gg          , Gg          , Hh          , Gg          , Ms          
Aa^Fpa      , Aa^Fpa      , Ww          , Ww          , Hh          , Gg          , Gs^Fp       , Re^Uf       , Rp          , Hh          , Rp          , Re^Gvs      , Rp          , Rp          , Rp          , Ggf         , Ww^Bw/      , Ww^Bw\      , Rp          , Re^Uf       , Gg          , Gg          , Aa^Vea      , Gg          , Gg          , Gg          , Ha          
Ai          , Ww          , Ww          , Ww          , Hh          , Mm          , Gg          , Gg          , Gg          , Rp          , Hh          , Cv          , Cv          , Cv          , Cv          , Cv          , Ww          , Ww          , Gs^Fp       , Rp          , Gg          , Gg          , Aa          , Aa          , Aa          , Gg          , Ha          
Ai          , Ai          , Ww          , Ww          , Aa          , Gs^Fp       , Aa          , Gg          , Aa          , Aa^Vha      , Aa          , Aa          , Aa^Fpa      , 2 Kv        , Aa          , Ww          , Ww          , Ww          , Ww          , Rp          , Gg          , Re^Uf       , Re^Uf       , Ha          , Aa^Fpa      , Aa^Fpa      , Aa^Fpa      
Ai          , Aa^Fpa      , Aa^Fpa      , Aa^Fpa      , Aa^Fpa      , Aa^Fpa      , Aa^Fpa      , Ha          , Ms          , Ms          , Aa^Fpa      , Aa^Fpa      , Aa^Fpa      , Aa^Fpa      , Aa^Fpa      , Aa^Fpa      , Ai          , Ai          , Ww          , Rp          , Aa^Fpa      , Re^Uf       , Aa^Fpa      , Aa^Fpa      , Aa^Fpa      , Re^Uf       , Aa^Fpa      
