border_size=1
usage=map

Mm^Xm       , Mm^Xm       , Mm^Xm       , Mm^Xm       , Mm^Xm       , Mm^Xm       , Gg^Fet      , Gg          , Gg^Fet      , Gg          , Gg^Fet      , Gg          , Ss          , Ss          , Ss          , Mm^Xm       , Mm^Xm       , Mm^Xm       , Mm^Xm       , Mm^Xm       , Mm^Xm       , Mm^Xm       , Mm^Xm       , Mm^Xm       , Mm^Xm       
Mm^Xm       , Mm^Xm       , Mm^Xm       , Mm^Xm       , Mm          , Mm^Xm       , Gg^Fet      , Gg^Fet      , Hh          , Gg^Fet      , Gg^Fet      , Gg^Fet      , Gg          , Ss          , Ss          , Mm^Xm       , Gg          , Mm^Xm       , Mm^Xm       , Mm^Xm       , Mm^Xm       , Mm^Xm       , Gs^Fp       , Mm^Xm       , Wwf         
Mm^Xm       , Mm          , Hh          , Hh          , Ss          , Hh          , Gg          , Gs^Fp       , Gg^Ve       , Gg          , Gg          , Hh          , Gg          , Gg          , Gg          , Gs^Fp       , Gg          , Gg          , Gg          , Gg          , Wwf         , Hh          , Gs^Fp       , Hh          , Wwf         
Mm^Xm       , Gs^Fp       , Hh          , Gs^Fp       , Gg          , Gg          , Gg          , Gg          , Rr          , Gg          , Gg          , Gg          , Gs^Fp       , Gg^Uf       , Gg          , Gg          , Gg^Ve       , Gg          , Ds          , Gg          , Wwf         , Wwf         , Wwf         , Wwf         , Wwf         
Mm^Xm       , Hh          , Gs^Fp       , Gg          , 1 Kh        , Ch          , Ch          , Rr          , Gg          , Rr          , Rr          , Gg^Vh       , Gg          , Mm          , Gg          , Gg          , Gg^Uf       , Hh          , Gg          , Wwf         , Wwf         , Wwf         , Wwf         , Wwf         , Wwf         
Mm^Xm       , Gg          , Ch          , Ch          , Ch          , Ch          , Gg          , Gg          , Hh          , Gg          , Gg          , Rr          , Rr          , Gg          , Ss          , Gg          , Mm^Xm       , Ss          , Wwf         , Wwf         , Hh          , Wwf         , Wwf         , Wwf         , Wwf         
Gg^Fet      , Gg          , Rp          , Kh          , Wwf         , Rr          , Rr          , Gg          , Mm^Xm       , Gs^Fp       , Gg          , Gg          , Gg          , Rr          , Rr          , Gg          , Wwf         , Wwf         , Ww          , Hh^Fmw      , Mm          , Uu^Uf       , Wwf         , Hh          , Wwf         
Ss          , Gg          , Gg          , Rr          , Rr          , Wwf         , Rr          , Gg          , Hh^Fp       , Mm^Xm       , Mm^Xm       , Gg          , Hh^Vhh      , Gs^Fp       , Gg^Uf       , Wwf         , Wwf         , Wwf         , Gs^Fp       , Gs^Fp       , Hh          , Ss          , Wwf         , Hh^Fp       , Wwf         
Hh^Fp       , Hh^Fmw      , Gg          , Rr          , Gg          , Wwf         , Wwf         , Uu^Uf       , Ss^Vhs      , Wwf         , Wwf         , Mm^Xm       , Gg          , Hh          , Wwf         , Wwf         , Wwf         , Wwf         , Wwf         , Gg^Uf       , Wwf         , Wwf         , Wwf         , Wwf         , Wwf         
Hh          , Gg          , Gg          , Rp          , Mm          , Rr          , Gg          , Wwf         , Wwf         , Wwf         , Wwf         , Gg^Fet      , Wwf         , Wo^Bw|      , Wwf         , Ww          , Wwf         , Wwf         , Mm^Xm       , Wwf         , Hh^Fmf      , Gg^Vh       , Gg          , Gs^Fp       , Gg^Fet      
Gg^Fet      , Gg^Ve       , Gg          , Rp          , Gg          , Gg          , Gs^Vht      , Mm^Xm       , Mm^Xm       , Wwf         , Wo          , Wwf         , Hh          , Gg          , Wo^Bw\      , Wwf         , Gg^Fet      , Gg          , Mm          , Gg          , Gg          , Gg          , Gg          , Hh          , Gg^Fet      
Hh          , Hh          , Gg          , Rr          , Gg          , Gg          , Gg          , Gg          , Wo^Bw\      , Wo          , Wo          , Mm^Xm       , Wwf         , Wo          , Wo          , Wo^Bw\      , Wo^Bw\      , Hh          , Gg          , Gg^Fet      , Gg          , Rr          , Gg          , Gs^Fp       , Hh          
Gg^Fet      , Gs^Fp       , Gg          , Rr          , Gg          , Gg^Fet      , Mm          , Hh          , Gg^Fet      , Wo^Bw\      , Wo^Bw\      , Wo          , Hh          , Mm^Xm       , Wo          , Wo          , Mm^Xm       , Gg          , Gs^Vht      , Gg          , Gg          , Rr          , Gg          , Hh          , Gg^Fet      
Gg^Fet      , Hh          , Gg          , Gg          , Hh^Fmf      , Gg          , Mm^Xm       , Gg          , Wwf         , Wwf         , Wwf         , Gg          , Wwf         , Wwf         , Wwf         , Wwf         , Wwf         , Mm^Xm       , Gg          , Gg          , Mm          , Rr          , Gg          , Gg^Ve       , Hh          
Wwf         , Gs^Fp       , Wwf         , Gg^Vh       , Wwf         , Wwf         , Wwf         , Wwf         , Wwf         , Ww          , Wwf         , Wo^Bw|      , Gg          , Gg^Fet      , Wwf         , Wwf         , Ss^Vhs      , Wwf         , Wwf         , Rr          , Gg          , Rr          , Gg          , Gg          , Gg^Fet      
Wwf         , Wwf         , Wwf         , Wwf         , Hh          , Gg^Uf       , Gs^Fp       , Wwf         , Wwf         , Wwf         , Gg^Uf       , Hh          , Hh^Vhh      , Mm^Xm       , Mm^Xm       , Wwf         , Hh^Fp       , Uu^Uf       , Rr          , Wwf         , Rp          , Rr          , Gg          , Hh^Fmw      , Ss          
Wwf         , Hh^Fp       , Wwf         , Ss          , Mm          , Gs^Fp       , Ww          , Wwf         , Wwf         , Wwf         , Rr          , Gs^Fp       , Gg          , Gg          , Gg          , Mm^Xm       , Mm^Xm       , Gg          , Rp          , Wwf         , Wwf         , Rr          , Gg          , Gg          , Gg^Fet      
Wwf         , Hh          , Wwf         , Uu^Uf       , Hh          , Hh^Fmw      , Wwf         , Wwf         , Mm^Xm       , Gg          , Ss          , Rr          , Rr          , Gg          , Gg          , Gs^Fp       , Hh          , Gg          , Gg          , Rp          , Ch          , Kh          , Ch          , Gg          , Mm^Xm       
Wwf         , Wwf         , Wwf         , Wwf         , Wwf         , Wwf         , Gg          , Ss          , Gg^Uf       , Gg          , Gg          , Gg          , Gg          , Rr          , Rr          , Gg          , Gg          , Gg          , Ch          , Ch          , 2 Kh        , Ch          , Gs^Fp       , Gg          , Mm^Xm       
Wwf         , Wwf         , Wwf         , Wwf         , Wwf         , Wwf         , Ds          , Hh          , Gg^Ve       , Gg          , Gg          , Mm          , Gs^Fp       , Gg^Vh       , Gg          , Rr          , Rr          , Rr          , Gg          , Ch          , Gg          , Gg          , Hh          , Hh          , Mm^Xm       
Wwf         , Wwf         , Gs^Fp       , Wwf         , Wwf         , Gg          , Gg          , Gg          , Gg          , Gg          , Gg          , Gg^Uf       , Gg          , Gg          , Gg          , Gg          , Gg          , Gg^Ve       , Gs^Fp       , Gg          , Ss          , Gs^Fp       , Hh          , Gs^Fp       , Mm^Xm       
Wwf         , Hh          , Mm^Xm       , Hh          , Mm^Xm       , Gg          , Mm^Xm       , Gg          , Gg          , Gs^Fp       , Ss          , Gg          , Gg          , Hh          , Gg^Fet      , Gg          , Hh          , Gg          , Gg^Fet      , Hh          , Mm          , Hh          , Mm          , Mm          , Mm^Xm       
Mm^Xm       , Mm^Xm       , Mm^Xm       , Mm^Xm       , Mm^Xm       , Mm^Xm       , Mm^Xm       , Mm^Xm       , Mm^Xm       , Ss          , Ss          , Ss          , Gg^Fet      , Gg^Fet      , Gg^Fet      , Hh          , Gg^Fet      , Gg^Fet      , Gg^Fet      , Mm^Xm       , Mm^Xm       , Mm^Xm       , Mm^Xm       , Mm^Xm       , Mm^Xm       
