border_size=1
usage=map

Ha          , Aa          , Ha          , Mm          , Ss          , Ss          , Gg          , Gg          , Hh          , Gg          , Mm          , Ce          , Ce          , Gs^Fp       , Gg          , Mm          , Ss          , Hh          , Hh          , Hh          , Chw         , Aa          , Ai          , Aa          , Aa          , Aa          , Wo          , Ww          , Ai          
Ha          , Aa^Fpa      , Hh          , Mm          , Gs^Fp       , Mm          , Gg          , Gg          , Hh          , Gs^Fp       , Mm          , Re          , Re          , Gs^Fp       , Ggf         , Mm          , Ss          , Hh          , Wwf         , Gg^Fet      , Chw         , Ww          , Ww          , Ww          , Aa          , Ai          , Ai          , Ai          , Ai          
Gg          , Gg          , Gg          , Ggf         , Gg^Ve       , Gg          , Ggf         , Gs^Fp       , Gs^Fp       , Ggf         , Hh          , Mm          , Gg          , Re          , Ww^Bw\      , Wwf         , Gs^Fp       , Wwf         , Hh          , Ss          , Wwf         , Chw         , Hh          , Aa^Fpa      , Ds          , Ww          , Ww          , Wo          , Ai          
Ms          , Ha          , Gg          , Re^Gvs      , Re^Gvs      , Re^Gvs      , Gg          , Ggf         , Re^Gvs      , Ss^Vhs      , Re^Gvs      , Gg          , Gg          , Wwf         , Wwf         , Re          , Ww^Bw\      , Wwf         , Mm          , Hh          , Re          , Wwf         , Wwf         , Wwf         , Wwf         , Gg^Fet      , Ww          , Ai          , Wo          
Aa          , Gg^Fet      , Gg          , Gg          , Gs^Fp       , Gg          , Gg          , Gg          , Gg          , Re^Gvs      , Gg          , Gg          , Gg          , Wwf         , Ggf         , Gs^Fp       , Wwf         , Re          , Re          , Gs^Fp       , Re          , Ss^Vhs      , Gs^Fp       , Gg          , Ggf         , Wwf         , Wwf         , Ww          , Wo          
Gg          , Gg          , Gg          , Ggf         , Mm          , Hh          , Re^Gvs      , Gg          , Gs^Fp       , Mm          , Gs^Fp       , Gs^Fp       , Ggf         , Hh          , Gs^Fp       , Hh          , Hh          , Gs^Fp       , Re          , Re          , Gg          , Re          , Mm          , Hh          , Ggf         , Wwf         , Wwf         , Aa^Vha      , Aa          
Ha          , Gg          , Gg          , Gs^Fp       , Gg          , Gs^Fp       , Gg^Vh       , Re^Gvs      , Re          , Hh          , Gs^Fp       , Mm          , Hh          , Gs^Fp       , Ggf         , Mm          , Gg          , Gg          , Re          , Ggf         , Ggf         , Re          , Gg          , Gg          , Gg^Vh       , Gg          , Aa          , Ai          , Ai          
Ms          , Mm          , Ch          , Gg          , Gg          , Re^Gvs      , Re          , Re          , Re          , Re          , Re          , Hh          , Gs^Fp       , Ss          , Ss          , Gg          , Gg          , Gg          , Gs^Fp       , Mm          , Gs^Fp       , Re          , Re          , Gg          , Re          , Gg          , Ch          , Gs^Fp       , Gg          
Ha          , Hh          , Ch          , Re^Gvs      , Re          , Re          , Gg          , Gg          , Gg          , Gs^Fp       , Hh          , Re          , Re^Gvs      , Ss          , Gs^Fp       , Hh          , Gg          , Gs^Fp       , Hh          , Hh          , Gg^Vh       , Gs^Fp       , Re          , Re          , Re          , Re^Gvs      , Ch          , Hh          , Hh          
Ha          , Ms          , Rr          , 1 Kh        , Re^Gvs      , Mm          , Hh          , Re          , Re^Gvs      , Gg^Vh       , Re^Gvs      , Re^Gvs      , Gg^Ve       , Ggf         , Mm          , Hh          , Gg          , Gg^Ve       , Gg          , Ggf         , Gg          , Re          , Hh          , Ggf         , Re^Gvs      , 4 Kh        , Hh          , Ms          , Ms          
Ha          , Ha          , Rr          , Ch          , Ch          , Gs^Fp       , Gg          , Re          , Re          , Re^Gvs      , Re          , Re^Gvs      , Hh          , Ggf         , Hh          , Gs^Fp       , Gg          , Gg          , Gg          , Mm          , Gs^Fp       , Hh          , Gs^Fp       , Re^Gvs      , Ch          , Ch          , Rr          , Ha^Fpa      , Hh          
Aa          , Aa^Fpa      , Aa          , Rr          , Ch          , Re^Gvs      , Re^Gvs      , Gg          , Gg          , Re          , Gg          , Re          , Gg          , Hh          , Re          , Ggf         , Gs^Fp       , Gg          , Hh          , Gg          , Gg          , Ggf         , Re^Gvs      , Re^Gvs      , Ch          , Rr          , Aa          , Aa^Fpa      , Ha          
Aa          , Aa          , Ms          , Rr          , Kh          , Rr          , Re^Gvs      , Gg^Vh       , Gs^Fp       , Hh          , Gs^Fp       , Re          , Gg          , Gs^Fp       , Re^Gvs      , Re^Gvs      , Re^Gvs      , Hh          , Ggf         , Gs^Fp       , Hh          , Gg^Vh       , Re^Gvs      , Rr          , Kh          , Rr          , Ms          , Ha          , Ha          
Ms          , Ms          , Rr          , Rr          , Rr          , Rr          , Re^Gvs      , Hh          , Hh          , Mm          , Ggf         , Re          , Re          , Re          , Re^Gvs      , Gg^Wm       , Re^Gvs      , Re          , Ggf         , Mm          , Hh          , Gg          , Re^Gvs      , Rr          , Rr          , Rr          , Rr          , Aa^Fpa      , Ha          
Ha          , Aa^Fpa      , Ms          , Rr          , Kh          , Rr          , Re^Gvs      , Gg          , Hh          , Gs^Fp       , Ggf         , Gg          , Gg          , Re          , Hh          , Re^Gvs      , Re          , Re          , Hh          , Gs^Fp       , Hh          , Gg          , Gs^Fp       , Rr          , Kh          , Rr          , Ms          , Ha          , Ha          
Aa          , Ha          , Aa          , Rr          , Ch          , Rr          , Re^Gvs      , Gg          , Gg          , Hh          , Hh          , Gs^Fp       , Gg          , Gg          , Ggf         , Mm          , Gs^Fp       , Re          , Re          , Re          , Gg          , Gg          , Re^Gvs      , Rr          , Ch          , Rr          , Aa          , Ha          , Ms          
Ha          , Aa^Fpa      , Rr          , Rr          , Ch          , Re^Gvs      , Hh          , Gg^Vh       , Gs^Fp       , Gg          , Gg          , Gg          , Re^Gvs      , Gg          , Hh          , Hh          , Hh          , Re          , Re^Gvs      , Re          , Gg          , Gg^Vh       , Gg          , Re^Gvs      , Ch          , Rr          , Rr          , Aa^Fpa      , Ha          
Ha          , Ha          , Rr          , Ch          , Re^Gvs      , Re^Gvs      , Mm          , Gs^Fp       , Gg          , Gs^Fp       , Gg          , Re^Gvs      , Gg^Ve       , Re^Gvs      , Gs^Fp       , Gs^Fp       , Ggf         , Re^Gvs      , Gg^Ve       , Re          , Re          , Re          , Hh          , Hh          , Re^Gvs      , Ch          , Rr          , Ha          , Ha          
Ha          , Rr          , Ch          , 3 Kh        , Re          , Gg          , Gg          , Gg          , Gg          , Gg          , Hh          , Re^Gvs      , Gg          , Hh          , Ggf         , Gs^Fp       , Re^Gvs      , Re^Gvs      , Gs^Fp       , Hh          , Re^Gvs      , Re          , Gg          , Gs^Fp       , Re          , 2 Kh        , Ch          , Ms          , Ha          
Ha          , Ms          , Ch          , Re^Gvs      , Re          , Gg          , Re          , Hh          , Gs^Fp       , Gs^Fp       , Hh          , Gg          , Gg          , Gg          , Ss          , Ss          , Mm          , Re          , Re          , Mm          , Re          , Re          , Re          , Re          , Gg          , Re^Gvs      , Ch          , Ha          , Ha          
Ms          , Hh          , Aa          , Re          , Gg^Vh       , Re          , Re          , Ggf         , Re^Gvs      , Mm          , Re^Gvs      , Re          , Gg          , Gg          , Gg          , Ss          , Hh          , Hh          , Ggf         , Re          , Re^Gvs      , Re^Gvs      , Gg          , Gg^Vh       , Gg          , Re          , Re          , Gs^Fp       , Re          
Aa          , Gs^Fp       , Wwf         , Gg          , Gg          , Re          , Gs^Fp       , Re          , Re          , Re^Gvs      , Gg^Vh       , Ggf         , Hh          , Gs^Fp       , Mm          , Gs^Fp       , Ggf         , Gs^Fp       , Gs^Fp       , Hh          , Mm          , Gg          , Gg          , Gg          , Gs^Fp       , Mm          , Re^Gvs      , Re          , Aa          
Ai          , Aa^Vha      , Wwf         , Wwf         , Gg          , Hh          , Gs^Fp       , Re          , Ggf         , Re          , Re          , Gs^Fp       , Wwf         , Hh          , Gs^Fp       , Hh          , Gg          , Hh          , Gg          , Hh          , Gs^Fp       , Gg          , Gs^Fp       , Hh          , Hh          , Ggf         , Gg^Vh       , Gg          , Aa          
Wo          , Ai          , Ww          , Wwf         , Wwf         , Ggf         , Ss^Vhs      , Re          , Gg          , Mm          , Gs^Fp       , Ww^Bw\      , Re          , Gs^Fp       , Wwf         , Wwf         , Gg          , Gg          , Ggf         , Gg          , Ggf         , Gg          , Gg          , Ggf         , Gs^Fp       , Re^Gvs      , Re^Gvs      , Gg          , Gg          
Wo          , Ww          , Ww          , Gg^Fet      , Ds          , Wwf         , Wwf         , Gg          , Gg          , Ggf         , Hh          , Wwf         , Hh          , Re          , Ww^Bw\      , Wwf         , Gg          , Gg          , Gs^Fp       , Ss^Vhs      , Hh          , Re^Gvs      , Re^Gvs      , Re^Gvs      , Gg          , Gg          , Gg          , Aa^Fpa      , Gg          
Ai          , Ai          , Ai          , Ww          , Aa^Fpa      , Hh          , Chw         , Wwf         , Ss          , Gg          , Wwf         , Wwf         , Wwf         , Wwf         , Ggf         , Re          , Re          , Gg          , Ggf         , Hh          , Ggf         , Re^Gvs      , Gg          , Hh          , Gg^Ve       , Gg          , Gg          , Gg          , Aa          
Wo          , Wo          , Aa          , Aa          , Ww          , Ww          , Ww          , Chw         , Gs^Fp       , Wwf         , Hh          , Ss          , Ggf         , Gg          , Mm          , Gs^Fp       , Hh          , Re          , Re          , Gs^Fp       , Hh          , Gg          , Gg          , Ggf         , Gs^Fp       , Gg          , Ms          , Ms          , Aa          
Ww          , Ai          , Ai          , Wo          , Wo          , Ai          , Gs^Fp       , Chw         , Hh          , Hh          , Gs^Fp       , Gs^Fp       , Ss          , Ss          , Mm          , Hh          , Hh          , Ce          , Ce          , Mm          , Hh          , Gg          , Gs^Fp       , Mm          , Mm          , Gg          , Ms          , Ha          , Hh          
